match_id,date,home_team,away_team,home_corner_kicks,away_corner_kicks,total_corners
12504355,2025-03-31,Cagliari,Monza,4,6,10
12504362,2025-03-31,Fiorentina,Atalanta,2,4,6
12504351,2025-03-31,Inter,Udinese,2,4,6
12501548,2025-03-31,Napoli,Milan,2,6,8
12504347,2025-03-31,Hellas Verona,Parma,5,5,10
12504350,2025-03-31,Lazio,Torino,3,2,5
12437568,2025-03-31,Getafe,Villarreal,3,1,4
12437570,2025-03-31,Barcelona,Girona FC,10,2,12
12437564,2025-03-31,Athletic Club,Osasuna,3,4,7
12437576,2025-03-31,Valencia,Mallorca,4,5,9
12437567,2025-03-31,Real Betis,Sevilla,2,2,4
12437569,2025-03-31,Celta Vigo,Las Palmas,1,1,2
12499449,2025-03-31,SC Freiburg,1. FC Union Berlin,3,3,6
12499444,2025-03-31,Borussia Dortmund,1. FSV Mainz 05,6,4,10
12450894,2025-03-31,Toulouse,Stade Brestois,10,3,13
12450266,2025-03-31,Angers,Stade Rennais,6,5,11
12450267,2025-03-31,Auxerre,Montpellier,10,6,16
12450265,2025-03-31,Le Havre,Nantes,3,4,7
12450898,2025-03-31,Lille,RC Lens,6,2,8
12504354,2025-03-30,Como,Empoli,4,1,5
12501546,2025-03-30,Venezia,Bologna,2,3,5
12504349,2025-03-30,Juventus,Genoa,4,3,7
12501547,2025-03-30,Lecce,Roma,6,6,12
12504355,2025-03-30,Cagliari,Monza,4,6,10
12504362,2025-03-30,Fiorentina,Atalanta,2,4,6
12504351,2025-03-30,Inter,Udinese,2,4,6
12501548,2025-03-30,Napoli,Milan,2,6,8
12437571,2025-03-30,Real Sociedad,Real Valladolid,3,6,9
12437881,2025-03-30,Espanyol,Atlético Madrid,4,3,7
12437572,2025-03-30,Deportivo Alavés,Rayo Vallecano,8,5,13
12437573,2025-03-30,Real Madrid,Leganés,8,3,11
12437568,2025-03-30,Getafe,Villarreal,3,1,4
12437570,2025-03-30,Barcelona,Girona FC,10,2,12
12437564,2025-03-30,Athletic Club,Osasuna,3,4,7
12437576,2025-03-30,Valencia,Mallorca,4,5,9
12437567,2025-03-30,Real Betis,Sevilla,2,2,4
12499451,2025-03-30,Borussia M'gladbach,RB Leipzig,5,8,13
12499443,2025-03-30,FC Bayern München,FC St. Pauli,5,4,9
12499453,2025-03-30,Holstein Kiel,SV Werder Bremen,3,4,7
12499446,2025-03-30,TSG Hoffenheim,FC Augsburg,2,2,4
12499450,2025-03-30,VfL Wolfsburg,1. FC Heidenheim,4,5,9
12499445,2025-03-30,Eintracht Frankfurt,VfB Stuttgart,6,10,16
12499449,2025-03-30,SC Freiburg,1. FC Union Berlin,3,3,6
12499444,2025-03-30,Borussia Dortmund,1. FSV Mainz 05,6,4,10
12450897,2025-03-30,Stade de Reims,Olympique de Marseille,0,12,12
12450895,2025-03-30,Saint-Étienne,Paris Saint-Germain,3,6,9
12450899,2025-03-30,AS Monaco,Nice,7,4,11
12450894,2025-03-30,Toulouse,Stade Brestois,10,3,13
12450266,2025-03-30,Angers,Stade Rennais,6,5,11
12450267,2025-03-30,Auxerre,Montpellier,10,6,16
12450265,2025-03-30,Le Havre,Nantes,3,4,7
12450898,2025-03-30,Lille,RC Lens,6,2,8
12504354,2025-03-29,Como,Empoli,4,1,5
12501546,2025-03-29,Venezia,Bologna,2,3,5
12504349,2025-03-29,Juventus,Genoa,4,3,7
12501547,2025-03-29,Lecce,Roma,6,6,12
12504355,2025-03-29,Cagliari,Monza,4,6,10
12437571,2025-03-29,Real Sociedad,Real Valladolid,3,6,9
12437881,2025-03-29,Espanyol,Atlético Madrid,4,3,7
12437572,2025-03-29,Deportivo Alavés,Rayo Vallecano,8,5,13
12437573,2025-03-29,Real Madrid,Leganés,8,3,11
12499441,2025-03-29,Bayer 04 Leverkusen,VfL Bochum 1848,3,2,5
12499451,2025-03-29,Borussia M'gladbach,RB Leipzig,5,8,13
12499443,2025-03-29,FC Bayern München,FC St. Pauli,5,4,9
12499453,2025-03-29,Holstein Kiel,SV Werder Bremen,3,4,7
12499446,2025-03-29,TSG Hoffenheim,FC Augsburg,2,2,4
12499450,2025-03-29,VfL Wolfsburg,1. FC Heidenheim,4,5,9
12499445,2025-03-29,Eintracht Frankfurt,VfB Stuttgart,6,10,16
12450268,2025-03-29,RC Strasbourg,Olympique Lyonnais,6,5,11
12450897,2025-03-29,Stade de Reims,Olympique de Marseille,0,12,12
12450895,2025-03-29,Saint-Étienne,Paris Saint-Germain,3,6,9
12450899,2025-03-29,AS Monaco,Nice,7,4,11
13637082,2025-03-28,Barcelona,Osasuna,8,4,12
12499441,2025-03-28,Bayer 04 Leverkusen,VfL Bochum 1848,3,2,5
12450268,2025-03-28,RC Strasbourg,Olympique Lyonnais,6,5,11
13637082,2025-03-27,Barcelona,Osasuna,8,4,12
12437017,2025-03-17,Arsenal,Chelsea,5,4,9
12437023,2025-03-17,Fulham,Tottenham Hotspur,6,5,11
12437027,2025-03-17,Leicester City,Manchester United,6,4,10
12504357,2025-03-17,Venezia,Napoli,3,8,11
12504366,2025-03-17,Bologna,Lazio,7,1,8
12504352,2025-03-17,Roma,Cagliari,8,3,11
12504363,2025-03-17,Fiorentina,Juventus,1,6,7
12504364,2025-03-17,Atalanta,Inter,2,6,8
12437560,2025-03-17,Leganés,Real Betis,3,7,10
12437559,2025-03-17,Sevilla,Athletic Club,4,6,10
12437563,2025-03-17,Osasuna,Getafe,3,2,5
12437553,2025-03-17,Rayo Vallecano,Real Sociedad,4,4,8
12437550,2025-03-17,Atlético Madrid,Barcelona,6,6,12
12499437,2025-03-17,VfL Bochum 1848,Eintracht Frankfurt,8,3,11
12499429,2025-03-17,1. FC Heidenheim,Holstein Kiel,3,5,8
12499427,2025-03-17,VfB Stuttgart,Bayer 04 Leverkusen,1,10,11
12450261,2025-03-17,Olympique Lyonnais,Le Havre,4,1,5
12450259,2025-03-17,Montpellier,Saint-Étienne,4,6,10
12450263,2025-03-17,RC Strasbourg,Toulouse,4,3,7
12450258,2025-03-17,Stade Brestois,Stade de Reims,4,4,8
12450257,2025-03-17,Paris Saint-Germain,Olympique de Marseille,5,5,10
12437021,2025-03-16,Everton,West Ham United,6,5,11
12437025,2025-03-16,Ipswich Town,Nottingham Forest,6,3,9
12437029,2025-03-16,Manchester City,Brighton & Hove Albion,4,5,9
12436578,2025-03-16,Southampton,Wolverhampton,5,1,6
12437014,2025-03-16,Bournemouth,Brentford,4,3,7
12437017,2025-03-16,Arsenal,Chelsea,5,4,9
12437023,2025-03-16,Fulham,Tottenham Hotspur,6,5,11
12437027,2025-03-16,Leicester City,Manchester United,6,4,10
12504361,2025-03-16,Monza,Parma,6,3,9
12504358,2025-03-16,Udinese,Hellas Verona,2,1,3
12504356,2025-03-16,Milan,Como,0,5,5
12504359,2025-03-16,Torino,Empoli,5,5,10
12504357,2025-03-16,Venezia,Napoli,3,8,11
12504366,2025-03-16,Bologna,Lazio,7,1,8
12504352,2025-03-16,Roma,Cagliari,8,3,11
12504363,2025-03-16,Fiorentina,Juventus,1,6,7
12504364,2025-03-16,Atalanta,Inter,2,6,8
12437557,2025-03-16,Real Valladolid,Celta Vigo,3,4,7
12437565,2025-03-16,Mallorca,Espanyol,6,2,8
12437562,2025-03-16,Villarreal,Real Madrid,11,4,15
12437556,2025-03-16,Girona FC,Valencia,9,4,13
12437560,2025-03-16,Leganés,Real Betis,3,7,10
12437559,2025-03-16,Sevilla,Athletic Club,4,6,10
12437563,2025-03-16,Osasuna,Getafe,3,2,5
12437553,2025-03-16,Rayo Vallecano,Real Sociedad,4,4,8
12437550,2025-03-16,Atlético Madrid,Barcelona,6,6,12
12499434,2025-03-16,1. FC Union Berlin,FC Bayern München,2,14,16
12499433,2025-03-16,1. FSV Mainz 05,SC Freiburg,1,4,5
12499432,2025-03-16,FC Augsburg,VfL Wolfsburg,1,4,5
12499431,2025-03-16,SV Werder Bremen,Borussia M'gladbach,4,1,5
12499428,2025-03-16,RB Leipzig,Borussia Dortmund,3,12,15
12499437,2025-03-16,VfL Bochum 1848,Eintracht Frankfurt,8,3,11
12499429,2025-03-16,1. FC Heidenheim,Holstein Kiel,3,5,8
12499427,2025-03-16,VfB Stuttgart,Bayer 04 Leverkusen,1,10,11
12450262,2025-03-16,Nantes,Lille,3,5,8
12450264,2025-03-16,Angers,AS Monaco,0,9,9
12450260,2025-03-16,RC Lens,Stade Rennais,5,4,9
12450261,2025-03-16,Olympique Lyonnais,Le Havre,4,1,5
12450259,2025-03-16,Montpellier,Saint-Étienne,4,6,10
12450263,2025-03-16,RC Strasbourg,Toulouse,4,3,7
12450258,2025-03-16,Stade Brestois,Stade de Reims,4,4,8
12450257,2025-03-16,Paris Saint-Germain,Olympique de Marseille,5,5,10
12437021,2025-03-15,Everton,West Ham United,6,5,11
12437025,2025-03-15,Ipswich Town,Nottingham Forest,6,3,9
12437029,2025-03-15,Manchester City,Brighton & Hove Albion,4,5,9
12436578,2025-03-15,Southampton,Wolverhampton,5,1,6
12437014,2025-03-15,Bournemouth,Brentford,4,3,7
12504360,2025-03-15,Genoa,Lecce,3,3,6
12504361,2025-03-15,Monza,Parma,6,3,9
12504358,2025-03-15,Udinese,Hellas Verona,2,1,3
12504356,2025-03-15,Milan,Como,0,5,5
12504359,2025-03-15,Torino,Empoli,5,5,10
12504357,2025-03-15,Venezia,Napoli,3,8,11
12437566,2025-03-15,Las Palmas,Deportivo Alavés,4,5,9
12437557,2025-03-15,Real Valladolid,Celta Vigo,3,4,7
12437565,2025-03-15,Mallorca,Espanyol,6,2,8
12437562,2025-03-15,Villarreal,Real Madrid,11,4,15
12437556,2025-03-15,Girona FC,Valencia,9,4,13
12499439,2025-03-15,FC St. Pauli,TSG Hoffenheim,11,2,13
12499434,2025-03-15,1. FC Union Berlin,FC Bayern München,2,14,16
12499433,2025-03-15,1. FSV Mainz 05,SC Freiburg,1,4,5
12499432,2025-03-15,FC Augsburg,VfL Wolfsburg,1,4,5
12499431,2025-03-15,SV Werder Bremen,Borussia M'gladbach,4,1,5
12499428,2025-03-15,RB Leipzig,Borussia Dortmund,3,12,15
12450256,2025-03-15,Nice,Auxerre,7,3,10
12450262,2025-03-15,Nantes,Lille,3,5,8
12450264,2025-03-15,Angers,AS Monaco,0,9,9
12450260,2025-03-15,RC Lens,Stade Rennais,5,4,9
12504360,2025-03-14,Genoa,Lecce,3,3,6
12437566,2025-03-14,Las Palmas,Deportivo Alavés,4,5,9
12499439,2025-03-14,FC St. Pauli,TSG Hoffenheim,11,2,13
12450256,2025-03-14,Nice,Auxerre,7,3,10
12437010,2025-03-11,West Ham United,Newcastle United,3,4,7
12504365,2025-03-11,Lazio,Udinese,4,9,13
12437880,2025-03-11,Espanyol,Girona FC,4,9,13
12436998,2025-03-10,Chelsea,Leicester City,12,2,14
12437009,2025-03-10,Tottenham Hotspur,Bournemouth,3,6,9
12437005,2025-03-10,Manchester United,Arsenal,2,9,11
12437010,2025-03-10,West Ham United,Newcastle United,3,4,7
12504381,2025-03-10,Hellas Verona,Bologna,1,3,4
12504373,2025-03-10,Napoli,Fiorentina,4,4,8
12501597,2025-03-10,Empoli,Roma,1,9,10
12504369,2025-03-10,Juventus,Atalanta,2,5,7
12504365,2025-03-10,Lazio,Udinese,4,9,13
12437558,2025-03-10,Getafe,Atlético Madrid,4,4,8
12437549,2025-03-10,Real Madrid,Rayo Vallecano,4,6,10
12437874,2025-03-10,Athletic Club,Mallorca,3,3,6
12437876,2025-03-10,Real Betis,Las Palmas,11,1,12
12437878,2025-03-10,Real Sociedad,Sevilla,6,3,9
12437880,2025-03-10,Espanyol,Girona FC,4,9,13
12499417,2025-03-10,Eintracht Frankfurt,1. FC Union Berlin,1,5,6
12499419,2025-03-10,TSG Hoffenheim,1. FC Heidenheim,6,4,10
12450249,2025-03-10,Stade Brestois,Angers,6,6,12
12450244,2025-03-10,Le Havre,Saint-Étienne,5,6,11
12450250,2025-03-10,Nantes,RC Strasbourg,3,9,12
12450243,2025-03-10,Stade de Reims,Auxerre,6,12,18
12450246,2025-03-10,Nice,Olympique Lyonnais,9,2,11
12437007,2025-03-09,Nottingham Forest,Manchester City,3,2,5
12436996,2025-03-09,Brighton & Hove Albion,Fulham,3,7,10
12437000,2025-03-09,Crystal Palace,Ipswich Town,5,4,9
12437003,2025-03-09,Liverpool,Southampton,6,4,10
12436994,2025-03-09,Brentford,Aston Villa,6,5,11
12437012,2025-03-09,Wolverhampton,Everton,5,5,10
12436998,2025-03-09,Chelsea,Leicester City,12,2,14
12437009,2025-03-09,Tottenham Hotspur,Bournemouth,3,6,9
12437005,2025-03-09,Manchester United,Arsenal,2,9,11
12501598,2025-03-09,Como,Venezia,3,5,8
12504368,2025-03-09,Parma,Torino,7,4,11
12504370,2025-03-09,Lecce,Milan,2,7,9
12504372,2025-03-09,Inter,Monza,13,1,14
12504381,2025-03-09,Hellas Verona,Bologna,1,3,4
12504373,2025-03-09,Napoli,Fiorentina,4,4,8
12501597,2025-03-09,Empoli,Roma,1,9,10
12504369,2025-03-09,Juventus,Atalanta,2,5,7
12437877,2025-03-09,Celta Vigo,Leganés,2,5,7
12437552,2025-03-09,Deportivo Alavés,Villarreal,1,6,7
12437879,2025-03-09,Valencia,Real Valladolid,5,4,9
12437558,2025-03-09,Getafe,Atlético Madrid,4,4,8
12437549,2025-03-09,Real Madrid,Rayo Vallecano,4,6,10
12437874,2025-03-09,Athletic Club,Mallorca,3,3,6
12437876,2025-03-09,Real Betis,Las Palmas,11,1,12
12437878,2025-03-09,Real Sociedad,Sevilla,6,3,9
12499413,2025-03-09,Bayer 04 Leverkusen,SV Werder Bremen,10,3,13
12499416,2025-03-09,Borussia Dortmund,FC Augsburg,12,3,15
12499414,2025-03-09,FC Bayern München,VfL Bochum 1848,9,3,12
12499426,2025-03-09,Holstein Kiel,VfB Stuttgart,3,1,4
12499421,2025-03-09,VfL Wolfsburg,FC St. Pauli,6,6,12
12499420,2025-03-09,SC Freiburg,RB Leipzig,2,6,8
12499417,2025-03-09,Eintracht Frankfurt,1. FC Union Berlin,1,5,6
12499419,2025-03-09,TSG Hoffenheim,1. FC Heidenheim,6,4,10
12450254,2025-03-09,Stade Rennais,Paris Saint-Germain,3,2,5
12450251,2025-03-09,Lille,Montpellier,7,1,8
12450253,2025-03-09,Olympique de Marseille,RC Lens,7,0,7
12450249,2025-03-09,Stade Brestois,Angers,6,6,12
12450244,2025-03-09,Le Havre,Saint-Étienne,5,6,11
12450250,2025-03-09,Nantes,RC Strasbourg,3,9,12
12450243,2025-03-09,Stade de Reims,Auxerre,6,12,18
12450246,2025-03-09,Nice,Olympique Lyonnais,9,2,11
12437007,2025-03-08,Nottingham Forest,Manchester City,3,2,5
12436996,2025-03-08,Brighton & Hove Albion,Fulham,3,7,10
12437000,2025-03-08,Crystal Palace,Ipswich Town,5,4,9
12437003,2025-03-08,Liverpool,Southampton,6,4,10
12436994,2025-03-08,Brentford,Aston Villa,6,5,11
12437012,2025-03-08,Wolverhampton,Everton,5,5,10
12501595,2025-03-08,Cagliari,Genoa,2,5,7
12501598,2025-03-08,Como,Venezia,3,5,8
12504368,2025-03-08,Parma,Torino,7,4,11
12504370,2025-03-08,Lecce,Milan,2,7,9
12504372,2025-03-08,Inter,Monza,13,1,14
12504381,2025-03-08,Hellas Verona,Bologna,1,3,4
12437877,2025-03-08,Celta Vigo,Leganés,2,5,7
12437552,2025-03-08,Deportivo Alavés,Villarreal,1,6,7
12437879,2025-03-08,Valencia,Real Valladolid,5,4,9
12499423,2025-03-08,Borussia M'gladbach,1. FSV Mainz 05,4,3,7
12499413,2025-03-08,Bayer 04 Leverkusen,SV Werder Bremen,10,3,13
12499416,2025-03-08,Borussia Dortmund,FC Augsburg,12,3,15
12499414,2025-03-08,FC Bayern München,VfL Bochum 1848,9,3,12
12499426,2025-03-08,Holstein Kiel,VfB Stuttgart,3,1,4
12499421,2025-03-08,VfL Wolfsburg,FC St. Pauli,6,6,12
12499420,2025-03-08,SC Freiburg,RB Leipzig,2,6,8
12450248,2025-03-08,Toulouse,AS Monaco,3,5,8
12450254,2025-03-08,Stade Rennais,Paris Saint-Germain,3,2,5
12450251,2025-03-08,Lille,Montpellier,7,1,8
12450253,2025-03-08,Olympique de Marseille,RC Lens,7,0,7
12501595,2025-03-07,Cagliari,Genoa,2,5,7
12499423,2025-03-07,Borussia M'gladbach,1. FSV Mainz 05,4,3,7
12450248,2025-03-07,Toulouse,AS Monaco,3,5,8
12501590,2025-03-04,Juventus,Hellas Verona,6,0,6
12501594,2025-03-03,Monza,Torino,1,4,5
12501582,2025-03-03,Bologna,Cagliari,4,1,5
12501592,2025-03-03,Genoa,Empoli,3,6,9
12501596,2025-03-03,Roma,Como,1,2,3
12501584,2025-03-03,Milan,Lazio,3,5,8
12501590,2025-03-03,Juventus,Hellas Verona,6,0,6
12437870,2025-03-03,Leganés,Getafe,2,6,8
12437864,2025-03-03,Barcelona,Real Sociedad,12,0,12
12437872,2025-03-03,Mallorca,Deportivo Alavés,3,9,12
12437866,2025-03-03,Osasuna,Valencia,3,3,6
12499408,2025-03-03,1. FC Union Berlin,Holstein Kiel,11,3,14
12499407,2025-03-03,FC Augsburg,SC Freiburg,5,2,7
12450234,2025-03-03,Olympique Lyonnais,Stade Brestois,2,5,7
12450242,2025-03-03,Angers,Toulouse,4,9,13
12450240,2025-03-03,Auxerre,RC Strasbourg,5,3,8
12450238,2025-03-03,Montpellier,Stade Rennais,6,5,11
12450235,2025-03-03,Olympique de Marseille,Nantes,3,2,5
12501580,2025-03-02,Atalanta,Venezia,3,2,5
12501589,2025-03-02,Napoli,Inter,12,3,15
12501591,2025-03-02,Udinese,Parma,7,7,14
12501594,2025-03-02,Monza,Torino,1,4,5
12501582,2025-03-02,Bologna,Cagliari,4,1,5
12501592,2025-03-02,Genoa,Empoli,3,6,9
12501596,2025-03-02,Roma,Como,1,2,3
12501584,2025-03-02,Milan,Lazio,3,5,8
12437869,2025-03-02,Girona FC,Celta Vigo,4,2,6
12437867,2025-03-02,Rayo Vallecano,Sevilla,6,6,12
12437865,2025-03-02,Real Betis,Real Madrid,9,2,11
12437868,2025-03-02,Atlético Madrid,Athletic Club,6,2,8
12437870,2025-03-02,Leganés,Getafe,2,6,8
12437864,2025-03-02,Barcelona,Real Sociedad,12,0,12
12437872,2025-03-02,Mallorca,Deportivo Alavés,3,9,12
12437866,2025-03-02,Osasuna,Valencia,3,3,6
12499404,2025-03-02,1. FC Heidenheim,Borussia M'gladbach,6,2,8
12499410,2025-03-02,FC St. Pauli,Borussia Dortmund,7,1,8
12499401,2025-03-02,RB Leipzig,1. FSV Mainz 05,7,1,8
12499405,2025-03-02,SV Werder Bremen,VfL Wolfsburg,8,2,10
12499409,2025-03-02,VfL Bochum 1848,TSG Hoffenheim,8,5,13
12499402,2025-03-02,Eintracht Frankfurt,Bayer 04 Leverkusen,2,6,8
12499408,2025-03-02,1. FC Union Berlin,Holstein Kiel,11,3,14
12499407,2025-03-02,FC Augsburg,SC Freiburg,5,2,7
12450239,2025-03-02,Saint-Étienne,Nice,3,4,7
12450237,2025-03-02,RC Lens,Le Havre,9,2,11
12450233,2025-03-02,Paris Saint-Germain,Lille,9,3,12
12450234,2025-03-02,Olympique Lyonnais,Stade Brestois,2,5,7
12450242,2025-03-02,Angers,Toulouse,4,9,13
12450240,2025-03-02,Auxerre,RC Strasbourg,5,3,8
12450238,2025-03-02,Montpellier,Stade Rennais,6,5,11
12450235,2025-03-02,Olympique de Marseille,Nantes,3,2,5
12501593,2025-03-01,Fiorentina,Lecce,5,2,7
12501580,2025-03-01,Atalanta,Venezia,3,2,5
12501589,2025-03-01,Napoli,Inter,12,3,15
12501591,2025-03-01,Udinese,Parma,7,7,14
12501594,2025-03-01,Monza,Torino,1,4,5
12437871,2025-03-01,Real Valladolid,Las Palmas,13,4,17
12437869,2025-03-01,Girona FC,Celta Vigo,4,2,6
12437867,2025-03-01,Rayo Vallecano,Sevilla,6,6,12
12437865,2025-03-01,Real Betis,Real Madrid,9,2,11
12437868,2025-03-01,Atlético Madrid,Athletic Club,6,2,8
12499400,2025-03-01,VfB Stuttgart,FC Bayern München,4,6,10
12499404,2025-03-01,1. FC Heidenheim,Borussia M'gladbach,6,2,8
12499410,2025-03-01,FC St. Pauli,Borussia Dortmund,7,1,8
12499401,2025-03-01,RB Leipzig,1. FSV Mainz 05,7,1,8
12499405,2025-03-01,SV Werder Bremen,VfL Wolfsburg,8,2,10
12499409,2025-03-01,VfL Bochum 1848,TSG Hoffenheim,8,5,13
12499402,2025-03-01,Eintracht Frankfurt,Bayer 04 Leverkusen,2,6,8
12450241,2025-03-01,AS Monaco,Stade de Reims,7,2,9
12450239,2025-03-01,Saint-Étienne,Nice,3,4,7
12450237,2025-03-01,RC Lens,Le Havre,9,2,11
12450233,2025-03-01,Paris Saint-Germain,Lille,9,3,12
13365051,2025-02-28,West Ham United,Leicester City,3,3,6
13416148,2025-02-28,Bologna,Milan,4,5,9
12501593,2025-02-28,Fiorentina,Lecce,5,2,7
12437871,2025-02-28,Real Valladolid,Las Palmas,13,4,17
12499400,2025-02-28,VfB Stuttgart,FC Bayern München,4,6,10
12450241,2025-02-28,AS Monaco,Stade de Reims,7,2,9
12436968,2025-02-27,Brentford,Everton,2,5,7
12436991,2025-02-27,Manchester United,Ipswich Town,5,6,11
12436974,2025-02-27,Nottingham Forest,Arsenal,3,11,14
12436975,2025-02-27,Tottenham Hotspur,Manchester City,8,3,11
12436988,2025-02-27,Liverpool,Newcastle United,4,2,6
13365051,2025-02-27,West Ham United,Leicester City,3,3,6
13416148,2025-02-27,Bologna,Milan,4,5,9
12436970,2025-02-26,Brighton & Hove Albion,Bournemouth,1,9,10
12436983,2025-02-26,Crystal Palace,Aston Villa,3,8,11
12436981,2025-02-26,Wolverhampton,Fulham,7,4,11
12436986,2025-02-26,Chelsea,Southampton,4,2,6
12436968,2025-02-26,Brentford,Everton,2,5,7
12436991,2025-02-26,Manchester United,Ipswich Town,5,6,11
12436974,2025-02-26,Nottingham Forest,Arsenal,3,11,14
12436975,2025-02-26,Tottenham Hotspur,Manchester City,8,3,11
12436988,2025-02-26,Liverpool,Newcastle United,4,2,6
12436970,2025-02-25,Brighton & Hove Albion,Bournemouth,1,9,10
12436983,2025-02-25,Crystal Palace,Aston Villa,3,8,11
12436981,2025-02-25,Wolverhampton,Fulham,7,4,11
12436986,2025-02-25,Chelsea,Southampton,4,2,6
12504371,2025-02-25,Roma,Monza,6,3,9
12437862,2025-02-25,Sevilla,Mallorca,4,4,8
12436963,2025-02-24,Newcastle United,Nottingham Forest,7,6,13
12436627,2025-02-24,Manchester City,Liverpool,7,5,12
12504378,2025-02-24,Como,Napoli,4,6,10
12504377,2025-02-24,Hellas Verona,Fiorentina,4,1,5
12504382,2025-02-24,Empoli,Atalanta,3,4,7
12504376,2025-02-24,Cagliari,Juventus,3,4,7
12504371,2025-02-24,Roma,Monza,6,3,9
12437850,2025-02-24,Athletic Club,Real Valladolid,4,4,8
12437861,2025-02-24,Real Madrid,Girona FC,11,5,16
12437860,2025-02-24,Getafe,Real Betis,2,5,7
12437863,2025-02-24,Real Sociedad,Leganés,3,3,6
12437862,2025-02-24,Sevilla,Mallorca,4,4,8
12499845,2025-02-24,RB Leipzig,1. FC Heidenheim,7,4,11
12499842,2025-02-24,FC Bayern München,Eintracht Frankfurt,4,1,5
12499390,2025-02-24,TSG Hoffenheim,VfB Stuttgart,4,8,12
12450888,2025-02-24,Nantes,RC Lens,2,11,13
12451047,2025-02-24,Le Havre,Toulouse,5,3,8
12450892,2025-02-24,Nice,Montpellier,8,5,13
12450887,2025-02-24,RC Strasbourg,Stade Brestois,1,8,9
12450236,2025-02-24,Olympique Lyonnais,Paris Saint-Germain,5,4,9
12436625,2025-02-23,Everton,Manchester United,7,8,15
12436960,2025-02-23,Arsenal,West Ham United,2,0,2
12436958,2025-02-23,Bournemouth,Wolverhampton,6,7,13
12436624,2025-02-23,Fulham,Crystal Palace,7,7,14
12436629,2025-02-23,Ipswich Town,Tottenham Hotspur,4,4,8
12436965,2025-02-23,Southampton,Brighton & Hove Albion,5,6,11
12436621,2025-02-23,Aston Villa,Chelsea,2,3,5
12436963,2025-02-23,Newcastle United,Nottingham Forest,7,6,13
12436627,2025-02-23,Manchester City,Liverpool,7,5,12
12504367,2025-02-23,Parma,Bologna,0,4,4
12501577,2025-02-23,Venezia,Lazio,6,6,12
12501588,2025-02-23,Torino,Milan,4,11,15
12504374,2025-02-23,Inter,Genoa,6,7,13
12504378,2025-02-23,Como,Napoli,4,6,10
12504377,2025-02-23,Hellas Verona,Fiorentina,4,1,5
12504382,2025-02-23,Empoli,Atalanta,3,4,7
12504376,2025-02-23,Cagliari,Juventus,3,4,7
12437857,2025-02-23,Deportivo Alavés,Espanyol,7,0,7
12437856,2025-02-23,Rayo Vallecano,Villarreal,3,5,8
12437858,2025-02-23,Valencia,Atlético Madrid,7,0,7
12437859,2025-02-23,Las Palmas,Barcelona,5,3,8
12437850,2025-02-23,Athletic Club,Real Valladolid,4,4,8
12437861,2025-02-23,Real Madrid,Girona FC,11,5,16
12437860,2025-02-23,Getafe,Real Betis,2,5,7
12437863,2025-02-23,Real Sociedad,Leganés,3,3,6
12499395,2025-02-23,1. FSV Mainz 05,FC St. Pauli,6,5,11
12499396,2025-02-23,Borussia M'gladbach,FC Augsburg,2,4,6
12499398,2025-02-23,Holstein Kiel,Bayer 04 Leverkusen,5,11,16
12499394,2025-02-23,VfL Wolfsburg,VfL Bochum 1848,3,5,8
12499389,2025-02-23,Borussia Dortmund,1. FC Union Berlin,5,3,8
12499845,2025-02-23,RB Leipzig,1. FC Heidenheim,7,4,11
12499842,2025-02-23,FC Bayern München,Eintracht Frankfurt,4,1,5
12499390,2025-02-23,TSG Hoffenheim,VfB Stuttgart,4,8,12
12450886,2025-02-23,Lille,AS Monaco,1,6,7
12450890,2025-02-23,Saint-Étienne,Angers,4,3,7
12450891,2025-02-23,Auxerre,Olympique de Marseille,2,5,7
12450888,2025-02-23,Nantes,RC Lens,2,11,13
12451047,2025-02-23,Le Havre,Toulouse,5,3,8
12450892,2025-02-23,Nice,Montpellier,8,5,13
12450887,2025-02-23,RC Strasbourg,Stade Brestois,1,8,9
12450236,2025-02-23,Olympique Lyonnais,Paris Saint-Germain,5,4,9
12436623,2025-02-22,Leicester City,Brentford,5,6,11
12436625,2025-02-22,Everton,Manchester United,7,8,15
12436960,2025-02-22,Arsenal,West Ham United,2,0,2
12436958,2025-02-22,Bournemouth,Wolverhampton,6,7,13
12436624,2025-02-22,Fulham,Crystal Palace,7,7,14
12436629,2025-02-22,Ipswich Town,Tottenham Hotspur,4,4,8
12436965,2025-02-22,Southampton,Brighton & Hove Albion,5,6,11
12436621,2025-02-22,Aston Villa,Chelsea,2,3,5
12504375,2025-02-22,Lecce,Udinese,11,8,19
12504367,2025-02-22,Parma,Bologna,0,4,4
12501577,2025-02-22,Venezia,Lazio,6,6,12
12501588,2025-02-22,Torino,Milan,4,11,15
12504374,2025-02-22,Inter,Genoa,6,7,13
12504378,2025-02-22,Como,Napoli,4,6,10
12437853,2025-02-22,Celta Vigo,Osasuna,5,4,9
12437857,2025-02-22,Deportivo Alavés,Espanyol,7,0,7
12437856,2025-02-22,Rayo Vallecano,Villarreal,3,5,8
12437858,2025-02-22,Valencia,Atlético Madrid,7,0,7
12437859,2025-02-22,Las Palmas,Barcelona,5,3,8
12499392,2025-02-22,SC Freiburg,SV Werder Bremen,3,7,10
12499395,2025-02-22,1. FSV Mainz 05,FC St. Pauli,6,5,11
12499396,2025-02-22,Borussia M'gladbach,FC Augsburg,2,4,6
12499398,2025-02-22,Holstein Kiel,Bayer 04 Leverkusen,5,11,16
12499394,2025-02-22,VfL Wolfsburg,VfL Bochum 1848,3,5,8
12499389,2025-02-22,Borussia Dortmund,1. FC Union Berlin,5,3,8
12451045,2025-02-22,Stade Rennais,Stade de Reims,9,2,11
12450886,2025-02-22,Lille,AS Monaco,1,6,7
12450890,2025-02-22,Saint-Étienne,Angers,4,3,7
12450891,2025-02-22,Auxerre,Olympique de Marseille,2,5,7
12436623,2025-02-21,Leicester City,Brentford,5,6,11
12504375,2025-02-21,Lecce,Udinese,11,8,19
12437853,2025-02-21,Celta Vigo,Osasuna,5,4,9
12499392,2025-02-21,SC Freiburg,SV Werder Bremen,3,7,10
12451045,2025-02-21,Stade Rennais,Stade de Reims,9,2,11
12437019,2025-02-20,Aston Villa,Liverpool,6,8,14
12437019,2025-02-19,Aston Villa,Liverpool,6,8,14
12504386,2025-02-18,Genoa,Venezia,4,5,9
12437806,2025-02-18,Barcelona,Rayo Vallecano,4,5,9
12436945,2025-02-17,Liverpool,Wolverhampton,4,3,7
12436952,2025-02-17,Tottenham Hotspur,Manchester United,10,5,15
12504390,2025-02-17,Fiorentina,Como,2,1,3
12504383,2025-02-17,Monza,Lecce,3,7,10
12504379,2025-02-17,Udinese,Empoli,9,5,14
12504380,2025-02-17,Parma,Roma,1,10,11
12504387,2025-02-17,Juventus,Inter,7,5,12
12504386,2025-02-17,Genoa,Venezia,4,5,9
12437821,2025-02-17,Espanyol,Athletic Club,2,7,9
12437830,2025-02-17,Real Valladolid,Sevilla,3,2,5
12437841,2025-02-17,Mallorca,Las Palmas,3,5,8
12437811,2025-02-17,Real Betis,Real Sociedad,5,5,10
12437806,2025-02-17,Barcelona,Rayo Vallecano,4,5,9
12499825,2025-02-17,SV Werder Bremen,TSG Hoffenheim,6,4,10
12499818,2025-02-17,Eintracht Frankfurt,Holstein Kiel,4,6,10
12499821,2025-02-17,1. FC Heidenheim,1. FSV Mainz 05,8,4,12
12451030,2025-02-17,Montpellier,Olympique Lyonnais,7,4,11
12451041,2025-02-17,Le Havre,Nice,6,2,8
12451032,2025-02-17,RC Lens,RC Strasbourg,7,3,10
12451039,2025-02-17,Stade de Reims,Angers,1,4,5
12451037,2025-02-17,Stade Rennais,Lille,4,8,12
12436943,2025-02-16,Leicester City,Arsenal,3,7,10
12436934,2025-02-16,Aston Villa,Ipswich Town,16,1,17
12436940,2025-02-16,Fulham,Nottingham Forest,8,4,12
12436948,2025-02-16,Manchester City,Newcastle United,7,4,11
12436950,2025-02-16,Southampton,Bournemouth,4,6,10
12436956,2025-02-16,West Ham United,Brentford,9,2,11
12436939,2025-02-16,Crystal Palace,Everton,6,2,8
12436945,2025-02-16,Liverpool,Wolverhampton,4,3,7
12436952,2025-02-16,Tottenham Hotspur,Manchester United,10,5,15
12504393,2025-02-16,Atalanta,Cagliari,8,2,10
12504385,2025-02-16,Lazio,Napoli,7,1,8
12504384,2025-02-16,Milan,Hellas Verona,10,7,17
12504390,2025-02-16,Fiorentina,Como,2,1,3
12504383,2025-02-16,Monza,Lecce,3,7,10
12504379,2025-02-16,Udinese,Empoli,9,5,14
12504380,2025-02-16,Parma,Roma,1,10,11
12504387,2025-02-16,Juventus,Inter,7,5,12
12437846,2025-02-16,Leganés,Deportivo Alavés,3,2,5
12437817,2025-02-16,Osasuna,Real Madrid,6,2,8
12437802,2025-02-16,Atlético Madrid,Celta Vigo,2,7,9
12437836,2025-02-16,Villarreal,Valencia,4,5,9
12437821,2025-02-16,Espanyol,Athletic Club,2,7,9
12437830,2025-02-16,Real Valladolid,Sevilla,3,2,5
12437841,2025-02-16,Mallorca,Las Palmas,3,5,8
12437811,2025-02-16,Real Betis,Real Sociedad,5,5,10
12499832,2025-02-16,1. FC Union Berlin,Borussia M'gladbach,4,5,9
12499838,2025-02-16,FC St. Pauli,SC Freiburg,2,6,8
12499815,2025-02-16,VfB Stuttgart,VfL Wolfsburg,7,5,12
12499835,2025-02-16,VfL Bochum 1848,Borussia Dortmund,2,8,10
12499811,2025-02-16,Bayer 04 Leverkusen,FC Bayern München,6,0,6
12499825,2025-02-16,SV Werder Bremen,TSG Hoffenheim,6,4,10
12499818,2025-02-16,Eintracht Frankfurt,Holstein Kiel,4,6,10
12499821,2025-02-16,1. FC Heidenheim,1. FSV Mainz 05,8,4,12
12451028,2025-02-16,Olympique de Marseille,Saint-Étienne,14,3,17
12451043,2025-02-16,AS Monaco,Nantes,9,1,10
12451026,2025-02-16,Toulouse,Paris Saint-Germain,5,2,7
12451030,2025-02-16,Montpellier,Olympique Lyonnais,7,4,11
12451041,2025-02-16,Le Havre,Nice,6,2,8
12451032,2025-02-16,RC Lens,RC Strasbourg,7,3,10
12451039,2025-02-16,Stade de Reims,Angers,1,4,5
12451037,2025-02-16,Stade Rennais,Lille,4,8,12
12436937,2025-02-15,Brighton & Hove Albion,Chelsea,2,9,11
12436943,2025-02-15,Leicester City,Arsenal,3,7,10
12436934,2025-02-15,Aston Villa,Ipswich Town,16,1,17
12436940,2025-02-15,Fulham,Nottingham Forest,8,4,12
12436948,2025-02-15,Manchester City,Newcastle United,7,4,11
12436950,2025-02-15,Southampton,Bournemouth,4,6,10
12436956,2025-02-15,West Ham United,Brentford,9,2,11
12436939,2025-02-15,Crystal Palace,Everton,6,2,8
12504388,2025-02-15,Bologna,Torino,8,2,10
12504393,2025-02-15,Atalanta,Cagliari,8,2,10
12504385,2025-02-15,Lazio,Napoli,7,1,8
12504384,2025-02-15,Milan,Hellas Verona,10,7,17
12504390,2025-02-15,Fiorentina,Como,2,1,3
12437825,2025-02-15,Girona FC,Getafe,3,3,6
12437846,2025-02-15,Leganés,Deportivo Alavés,3,2,5
12437817,2025-02-15,Osasuna,Real Madrid,6,2,8
12437802,2025-02-15,Atlético Madrid,Celta Vigo,2,7,9
12437836,2025-02-15,Villarreal,Valencia,4,5,9
12499828,2025-02-15,FC Augsburg,RB Leipzig,8,9,17
12499832,2025-02-15,1. FC Union Berlin,Borussia M'gladbach,4,5,9
12499838,2025-02-15,FC St. Pauli,SC Freiburg,2,6,8
12499815,2025-02-15,VfB Stuttgart,VfL Wolfsburg,7,5,12
12499835,2025-02-15,VfL Bochum 1848,Borussia Dortmund,2,8,10
12499811,2025-02-15,Bayer 04 Leverkusen,FC Bayern München,6,0,6
12451035,2025-02-15,Stade Brestois,Auxerre,6,4,10
12451028,2025-02-15,Olympique de Marseille,Saint-Étienne,14,3,17
12451043,2025-02-15,AS Monaco,Nantes,9,1,10
12451026,2025-02-15,Toulouse,Paris Saint-Germain,5,2,7
12436937,2025-02-14,Brighton & Hove Albion,Chelsea,2,9,11
12504388,2025-02-14,Bologna,Torino,8,2,10
12437825,2025-02-14,Girona FC,Getafe,3,3,6
12499828,2025-02-14,FC Augsburg,RB Leipzig,8,9,17
12451035,2025-02-14,Stade Brestois,Auxerre,6,4,10
13344418,2025-02-13,Everton,Liverpool,2,3,5
13344418,2025-02-12,Everton,Liverpool,2,3,5
12504396,2025-02-11,Inter,Fiorentina,8,1,9
12437754,2025-02-11,Mallorca,Osasuna,7,11,18
12504389,2025-02-10,Venezia,Roma,4,6,10
12504398,2025-02-10,Cagliari,Parma,7,6,13
12504395,2025-02-10,Lazio,Monza,8,1,9
12504392,2025-02-10,Lecce,Bologna,6,5,11
12504394,2025-02-10,Napoli,Udinese,6,6,12
12504396,2025-02-10,Inter,Fiorentina,8,1,9
12437770,2025-02-10,Deportivo Alavés,Getafe,8,3,11
12437791,2025-02-10,Valencia,Leganés,9,3,12
12437796,2025-02-10,Real Sociedad,Espanyol,6,0,6
12437781,2025-02-10,Sevilla,Barcelona,5,6,11
12437754,2025-02-10,Mallorca,Osasuna,7,11,18
12499807,2025-02-10,Holstein Kiel,VfL Bochum 1848,3,5,8
12499782,2025-02-10,RB Leipzig,FC St. Pauli,5,4,9
12451020,2025-02-10,Olympique Lyonnais,Stade de Reims,6,6,12
12451007,2025-02-10,Auxerre,Toulouse,3,5,8
12451011,2025-02-10,RC Strasbourg,Montpellier,6,2,8
12451022,2025-02-10,Angers,Olympique de Marseille,1,7,8
12504397,2025-02-09,Hellas Verona,Atalanta,7,2,9
12504401,2025-02-09,Empoli,Milan,2,6,8
12504391,2025-02-09,Torino,Genoa,4,2,6
12504389,2025-02-09,Venezia,Roma,4,6,10
12504398,2025-02-09,Cagliari,Parma,7,6,13
12504395,2025-02-09,Lazio,Monza,8,1,9
12504392,2025-02-09,Lecce,Bologna,6,5,11
12504394,2025-02-09,Napoli,Udinese,6,6,12
12437786,2025-02-09,Celta Vigo,Real Betis,4,7,11
12437749,2025-02-09,Athletic Club,Girona FC,11,2,13
12437765,2025-02-09,Las Palmas,Villarreal,6,5,11
12437775,2025-02-09,Real Madrid,Atlético Madrid,6,1,7
12437770,2025-02-09,Deportivo Alavés,Getafe,8,3,11
12437791,2025-02-09,Valencia,Leganés,9,3,12
12437796,2025-02-09,Real Sociedad,Espanyol,6,0,6
12437781,2025-02-09,Sevilla,Barcelona,5,6,11
12499801,2025-02-09,1. FSV Mainz 05,FC Augsburg,1,3,4
12499786,2025-02-09,Borussia Dortmund,VfB Stuttgart,9,4,13
12499793,2025-02-09,SC Freiburg,1. FC Heidenheim,6,3,9
12499790,2025-02-09,TSG Hoffenheim,1. FC Union Berlin,8,4,12
12499796,2025-02-09,VfL Wolfsburg,Bayer 04 Leverkusen,3,9,12
12499805,2025-02-09,Borussia M'gladbach,Eintracht Frankfurt,6,1,7
12499807,2025-02-09,Holstein Kiel,VfL Bochum 1848,3,5,8
12499782,2025-02-09,RB Leipzig,FC St. Pauli,5,4,9
12451024,2025-02-09,Nice,RC Lens,7,3,10
12451013,2025-02-09,Lille,Le Havre,8,10,18
12451015,2025-02-09,Saint-Étienne,Stade Rennais,2,4,6
12451020,2025-02-09,Olympique Lyonnais,Stade de Reims,6,6,12
12451007,2025-02-09,Auxerre,Toulouse,3,5,8
12451011,2025-02-09,RC Strasbourg,Montpellier,6,2,8
12451022,2025-02-09,Angers,Olympique de Marseille,1,7,8
12504403,2025-02-08,Como,Juventus,9,1,10
12504397,2025-02-08,Hellas Verona,Atalanta,7,2,9
12504401,2025-02-08,Empoli,Milan,2,6,8
12504391,2025-02-08,Torino,Genoa,4,2,6
12504389,2025-02-08,Venezia,Roma,4,6,10
12437760,2025-02-08,Rayo Vallecano,Real Valladolid,4,2,6
12437786,2025-02-08,Celta Vigo,Real Betis,4,7,11
12437749,2025-02-08,Athletic Club,Girona FC,11,2,13
12437765,2025-02-08,Las Palmas,Villarreal,6,5,11
12437775,2025-02-08,Real Madrid,Atlético Madrid,6,1,7
12499779,2025-02-08,FC Bayern München,SV Werder Bremen,5,2,7
12499801,2025-02-08,1. FSV Mainz 05,FC Augsburg,1,3,4
12499786,2025-02-08,Borussia Dortmund,VfB Stuttgart,9,4,13
12499793,2025-02-08,SC Freiburg,1. FC Heidenheim,6,3,9
12499790,2025-02-08,TSG Hoffenheim,1. FC Union Berlin,8,4,12
12499796,2025-02-08,VfL Wolfsburg,Bayer 04 Leverkusen,3,9,12
12499805,2025-02-08,Borussia M'gladbach,Eintracht Frankfurt,6,1,7
12451009,2025-02-08,Nantes,Stade Brestois,12,4,16
12451018,2025-02-08,Paris Saint-Germain,AS Monaco,1,1,2
12451024,2025-02-08,Nice,RC Lens,7,3,10
12451013,2025-02-08,Lille,Le Havre,8,10,18
12451015,2025-02-08,Saint-Étienne,Stade Rennais,2,4,6
12504676,2025-02-07,Fiorentina,Inter,1,8,9
12504403,2025-02-07,Como,Juventus,9,1,10
12437760,2025-02-07,Rayo Vallecano,Real Valladolid,4,2,6
12499779,2025-02-07,FC Bayern München,SV Werder Bremen,5,2,7
12451009,2025-02-07,Nantes,Stade Brestois,12,4,16
12451018,2025-02-07,Paris Saint-Germain,AS Monaco,1,1,2
12504676,2025-02-06,Fiorentina,Inter,1,8,9
12436919,2025-02-04,Chelsea,West Ham United,4,3,7
12504410,2025-02-04,Cagliari,Lazio,7,7,14
12437701,2025-02-04,Girona FC,Las Palmas,11,3,14
12436916,2025-02-03,Brentford,Tottenham Hotspur,10,3,13
12436925,2025-02-03,Manchester United,Crystal Palace,11,0,11
12436913,2025-02-03,Arsenal,Manchester City,5,2,7
12436919,2025-02-03,Chelsea,West Ham United,4,3,7
12504407,2025-02-03,Juventus,Empoli,8,6,14
12504408,2025-02-03,Fiorentina,Genoa,1,8,9
12504404,2025-02-03,Milan,Inter,8,11,19
12504402,2025-02-03,Roma,Napoli,2,3,5
12504410,2025-02-03,Cagliari,Lazio,7,7,14
12437743,2025-02-03,Barcelona,Deportivo Alavés,5,2,7
12437737,2025-02-03,Valencia,Celta Vigo,5,2,7
12437707,2025-02-03,Osasuna,Real Sociedad,3,5,8
12437732,2025-02-03,Real Betis,Athletic Club,3,7,10
12437701,2025-02-03,Girona FC,Las Palmas,11,3,14
12499759,2025-02-03,Eintracht Frankfurt,VfL Wolfsburg,9,1,10
12499749,2025-02-03,Bayer 04 Leverkusen,TSG Hoffenheim,3,3,6
12451000,2025-02-03,Toulouse,Nice,7,2,9
12450998,2025-02-03,Angers,Le Havre,4,2,6
12451003,2025-02-03,Stade Rennais,RC Strasbourg,6,2,8
12450996,2025-02-03,Stade de Reims,Nantes,9,3,12
12450987,2025-02-03,Olympique de Marseille,Olympique Lyonnais,6,2,8
12436930,2025-02-02,Nottingham Forest,Brighton & Hove Albion,4,6,10
12436911,2025-02-02,Bournemouth,Liverpool,3,3,6
12436921,2025-02-02,Everton,Leicester City,5,6,11
12436924,2025-02-02,Ipswich Town,Southampton,1,2,3
12436928,2025-02-02,Newcastle United,Fulham,3,7,10
12436932,2025-02-02,Wolverhampton,Aston Villa,5,8,13
12436916,2025-02-02,Brentford,Tottenham Hotspur,10,3,13
12436925,2025-02-02,Manchester United,Crystal Palace,11,0,11
12436913,2025-02-02,Arsenal,Manchester City,5,2,7
12504405,2025-02-02,Monza,Hellas Verona,7,3,10
12504399,2025-02-02,Udinese,Venezia,4,6,10
12504411,2025-02-02,Atalanta,Torino,8,0,8
12504406,2025-02-02,Bologna,Como,4,2,6
12504407,2025-02-02,Juventus,Empoli,8,6,14
12504408,2025-02-02,Fiorentina,Genoa,1,8,9
12504404,2025-02-02,Milan,Inter,8,11,19
12504402,2025-02-02,Roma,Napoli,2,3,5
12437695,2025-02-02,Getafe,Sevilla,6,5,11
12437713,2025-02-02,Villarreal,Real Valladolid,3,6,9
12437689,2025-02-02,Atlético Madrid,Mallorca,10,4,14
12437725,2025-02-02,Espanyol,Real Madrid,1,8,9
12437743,2025-02-02,Barcelona,Deportivo Alavés,5,2,7
12437737,2025-02-02,Valencia,Celta Vigo,5,2,7
12437707,2025-02-02,Osasuna,Real Sociedad,3,5,8
12437732,2025-02-02,Real Betis,Athletic Club,3,7,10
12499762,2025-02-02,1. FC Heidenheim,Borussia Dortmund,4,5,9
12499755,2025-02-02,FC Bayern München,Holstein Kiel,12,1,13
12499776,2025-02-02,FC St. Pauli,FC Augsburg,3,1,4
12499752,2025-02-02,VfB Stuttgart,Borussia M'gladbach,2,0,2
12499772,2025-02-02,VfL Bochum 1848,SC Freiburg,9,7,16
12499769,2025-02-02,1. FC Union Berlin,RB Leipzig,4,5,9
12499759,2025-02-02,Eintracht Frankfurt,VfL Wolfsburg,9,1,10
12499749,2025-02-02,Bayer 04 Leverkusen,TSG Hoffenheim,3,3,6
12450990,2025-02-02,Stade Brestois,Paris Saint-Germain,4,7,11
12451005,2025-02-02,AS Monaco,Auxerre,5,4,9
12450994,2025-02-02,Lille,Saint-Étienne,7,1,8
12451000,2025-02-02,Toulouse,Nice,7,2,9
12450998,2025-02-02,Angers,Le Havre,4,2,6
12451003,2025-02-02,Stade Rennais,RC Strasbourg,6,2,8
12450996,2025-02-02,Stade de Reims,Nantes,9,3,12
12450987,2025-02-02,Olympique de Marseille,Olympique Lyonnais,6,2,8
12436930,2025-02-01,Nottingham Forest,Brighton & Hove Albion,4,6,10
12436911,2025-02-01,Bournemouth,Liverpool,3,3,6
12436921,2025-02-01,Everton,Leicester City,5,6,11
12436924,2025-02-01,Ipswich Town,Southampton,1,2,3
12436928,2025-02-01,Newcastle United,Fulham,3,7,10
12436932,2025-02-01,Wolverhampton,Aston Villa,5,8,13
12504400,2025-02-01,Parma,Lecce,3,2,5
12504405,2025-02-01,Monza,Hellas Verona,7,3,10
12504399,2025-02-01,Udinese,Venezia,4,6,10
12504411,2025-02-01,Atalanta,Torino,8,0,8
12504406,2025-02-01,Bologna,Como,4,2,6
12504407,2025-02-01,Juventus,Empoli,8,6,14
12437719,2025-02-01,Leganés,Rayo Vallecano,2,9,11
12437695,2025-02-01,Getafe,Sevilla,6,5,11
12437713,2025-02-01,Villarreal,Real Valladolid,3,6,9
12437689,2025-02-01,Atlético Madrid,Mallorca,10,4,14
12437725,2025-02-01,Espanyol,Real Madrid,1,8,9
12499766,2025-02-01,SV Werder Bremen,1. FSV Mainz 05,3,8,11
12499762,2025-02-01,1. FC Heidenheim,Borussia Dortmund,4,5,9
12499755,2025-02-01,FC Bayern München,Holstein Kiel,12,1,13
12499776,2025-02-01,FC St. Pauli,FC Augsburg,3,1,4
12499752,2025-02-01,VfB Stuttgart,Borussia M'gladbach,2,0,2
12499772,2025-02-01,VfL Bochum 1848,SC Freiburg,9,7,16
12499769,2025-02-01,1. FC Union Berlin,RB Leipzig,4,5,9
12450992,2025-02-01,Montpellier,RC Lens,4,5,9
12450990,2025-02-01,Stade Brestois,Paris Saint-Germain,4,7,11
12451005,2025-02-01,AS Monaco,Auxerre,5,4,9
12450994,2025-02-01,Lille,Saint-Étienne,7,1,8
12504400,2025-01-31,Parma,Lecce,3,2,5
12437719,2025-01-31,Leganés,Rayo Vallecano,2,9,11
12499766,2025-01-31,SV Werder Bremen,1. FSV Mainz 05,3,8,11
12450992,2025-01-31,Montpellier,RC Lens,4,5,9
12504412,2025-01-28,Venezia,Hellas Verona,7,9,16
12504417,2025-01-28,Genoa,Monza,9,6,15
12437649,2025-01-28,Deportivo Alavés,Celta Vigo,3,4,7
12436897,2025-01-27,Crystal Palace,Brentford,4,7,11
12436907,2025-01-27,Tottenham Hotspur,Leicester City,6,4,10
12436893,2025-01-27,Aston Villa,West Ham United,4,3,7
12436899,2025-01-27,Fulham,Manchester United,3,0,3
12504415,2025-01-27,Milan,Parma,7,4,11
12504414,2025-01-27,Udinese,Roma,1,5,6
12504419,2025-01-27,Lecce,Inter,7,0,7
12504416,2025-01-27,Lazio,Fiorentina,14,2,16
12504412,2025-01-27,Venezia,Hellas Verona,7,9,16
12504417,2025-01-27,Genoa,Monza,9,6,15
12437671,2025-01-27,Rayo Vallecano,Girona FC,4,1,5
12437665,2025-01-27,Real Sociedad,Getafe,5,2,7
12437614,2025-01-27,Athletic Club,Leganés,16,1,17
12437633,2025-01-27,Barcelona,Valencia,14,4,18
12437649,2025-01-27,Deportivo Alavés,Celta Vigo,3,4,7
12499725,2025-01-27,TSG Hoffenheim,Eintracht Frankfurt,9,3,12
12499745,2025-01-27,FC St. Pauli,1. FC Union Berlin,5,7,12
12450976,2025-01-27,Le Havre,Stade Brestois,6,6,12
12450970,2025-01-27,Nantes,Olympique Lyonnais,4,8,12
12450981,2025-01-27,RC Lens,Angers,4,4,8
12450974,2025-01-27,Toulouse,Montpellier,6,2,8
12450985,2025-01-27,Nice,Olympique de Marseille,6,12,18
12436891,2025-01-26,Bournemouth,Nottingham Forest,3,9,12
12436895,2025-01-26,Brighton & Hove Albion,Everton,9,1,10
12436901,2025-01-26,Liverpool,Ipswich Town,3,4,7
12436905,2025-01-26,Southampton,Newcastle United,3,8,11
12436909,2025-01-26,Wolverhampton,Arsenal,1,5,6
12436903,2025-01-26,Manchester City,Chelsea,2,3,5
12436897,2025-01-26,Crystal Palace,Brentford,4,7,11
12436907,2025-01-26,Tottenham Hotspur,Leicester City,6,4,10
12436893,2025-01-26,Aston Villa,West Ham United,4,3,7
12436899,2025-01-26,Fulham,Manchester United,3,0,3
12504420,2025-01-26,Como,Atalanta,4,5,9
12504413,2025-01-26,Napoli,Juventus,9,1,10
12504422,2025-01-26,Empoli,Bologna,2,4,6
12504415,2025-01-26,Milan,Parma,7,4,11
12504414,2025-01-26,Udinese,Roma,1,5,6
12504419,2025-01-26,Lecce,Inter,7,0,7
12504416,2025-01-26,Lazio,Fiorentina,14,2,16
12437657,2025-01-26,Mallorca,Real Betis,4,4,8
12437622,2025-01-26,Atlético Madrid,Villarreal,5,6,11
12437683,2025-01-26,Sevilla,Espanyol,5,1,6
12437677,2025-01-26,Real Valladolid,Real Madrid,1,7,8
12437671,2025-01-26,Rayo Vallecano,Girona FC,4,1,5
12437665,2025-01-26,Real Sociedad,Getafe,5,2,7
12437614,2025-01-26,Athletic Club,Leganés,16,1,17
12437633,2025-01-26,Barcelona,Valencia,14,4,18
12499739,2025-01-26,1. FSV Mainz 05,VfB Stuttgart,9,2,11
12499722,2025-01-26,Borussia Dortmund,SV Werder Bremen,5,5,10
12499732,2025-01-26,FC Augsburg,1. FC Heidenheim,6,4,10
12499718,2025-01-26,RB Leipzig,Bayer 04 Leverkusen,7,3,10
12499729,2025-01-26,SC Freiburg,FC Bayern München,2,4,6
12499741,2025-01-26,Borussia M'gladbach,VfL Bochum 1848,8,7,15
12499725,2025-01-26,TSG Hoffenheim,Eintracht Frankfurt,9,3,12
12499745,2025-01-26,FC St. Pauli,1. FC Union Berlin,5,7,12
12450972,2025-01-26,AS Monaco,Stade Rennais,4,2,6
12450968,2025-01-26,RC Strasbourg,Lille,6,7,13
12450983,2025-01-26,Paris Saint-Germain,Stade de Reims,8,1,9
12450976,2025-01-26,Le Havre,Stade Brestois,6,6,12
12450970,2025-01-26,Nantes,Olympique Lyonnais,4,8,12
12450981,2025-01-26,RC Lens,Angers,4,4,8
12450974,2025-01-26,Toulouse,Montpellier,6,2,8
12450985,2025-01-26,Nice,Olympique de Marseille,6,12,18
12436891,2025-01-25,Bournemouth,Nottingham Forest,3,9,12
12436895,2025-01-25,Brighton & Hove Albion,Everton,9,1,10
12436901,2025-01-25,Liverpool,Ipswich Town,3,4,7
12436905,2025-01-25,Southampton,Newcastle United,3,8,11
12436909,2025-01-25,Wolverhampton,Arsenal,1,5,6
12436903,2025-01-25,Manchester City,Chelsea,2,3,5
12504409,2025-01-25,Torino,Cagliari,6,3,9
12504420,2025-01-25,Como,Atalanta,4,5,9
12504413,2025-01-25,Napoli,Juventus,9,1,10
12504422,2025-01-25,Empoli,Bologna,2,4,6
12504415,2025-01-25,Milan,Parma,7,4,11
12437643,2025-01-25,Las Palmas,Osasuna,4,2,6
12437657,2025-01-25,Mallorca,Real Betis,4,4,8
12437622,2025-01-25,Atlético Madrid,Villarreal,5,6,11
12437683,2025-01-25,Sevilla,Espanyol,5,1,6
12437677,2025-01-25,Real Valladolid,Real Madrid,1,7,8
12499735,2025-01-25,VfL Wolfsburg,Holstein Kiel,10,3,13
12499739,2025-01-25,1. FSV Mainz 05,VfB Stuttgart,9,2,11
12499722,2025-01-25,Borussia Dortmund,SV Werder Bremen,5,5,10
12499732,2025-01-25,FC Augsburg,1. FC Heidenheim,6,4,10
12499718,2025-01-25,RB Leipzig,Bayer 04 Leverkusen,7,3,10
12499729,2025-01-25,SC Freiburg,FC Bayern München,2,4,6
12499741,2025-01-25,Borussia M'gladbach,VfL Bochum 1848,8,7,15
12450979,2025-01-25,Auxerre,Saint-Étienne,3,4,7
12450972,2025-01-25,AS Monaco,Stade Rennais,4,2,6
12450968,2025-01-25,RC Strasbourg,Lille,6,7,13
12450983,2025-01-25,Paris Saint-Germain,Stade de Reims,8,1,9
12504409,2025-01-24,Torino,Cagliari,6,3,9
12437643,2025-01-24,Las Palmas,Osasuna,4,2,6
12499735,2025-01-24,VfL Wolfsburg,Holstein Kiel,10,3,13
12450979,2025-01-24,Auxerre,Saint-Étienne,3,4,7
12436455,2025-01-21,Chelsea,Wolverhampton,3,6,9
12504430,2025-01-21,Como,Udinese,3,2,5
12437840,2025-01-21,Villarreal,Mallorca,6,5,11
12436448,2025-01-20,Everton,Tottenham Hotspur,3,8,11
12436883,2025-01-20,Manchester United,Brighton & Hove Albion,4,2,6
12436887,2025-01-20,Nottingham Forest,Southampton,2,8,10
12436439,2025-01-20,Ipswich Town,Manchester City,4,7,11
12436455,2025-01-20,Chelsea,Wolverhampton,3,6,9
12504425,2025-01-20,Fiorentina,Torino,9,2,11
12504429,2025-01-20,Cagliari,Lecce,6,1,7
12504423,2025-01-20,Parma,Venezia,8,2,10
12504418,2025-01-20,Hellas Verona,Lazio,5,6,11
12504421,2025-01-20,Inter,Empoli,7,3,10
12504430,2025-01-20,Como,Udinese,3,2,5
12437834,2025-01-20,Celta Vigo,Athletic Club,3,4,7
12437845,2025-01-20,Real Madrid,Las Palmas,8,2,10
12437829,2025-01-20,Osasuna,Rayo Vallecano,6,3,9
12437844,2025-01-20,Valencia,Real Sociedad,4,7,11
12437840,2025-01-20,Villarreal,Mallorca,6,5,11
12499708,2025-01-20,1. FC Union Berlin,1. FSV Mainz 05,2,2,4
12499704,2025-01-20,SV Werder Bremen,FC Augsburg,6,2,8
12450957,2025-01-20,Saint-Étienne,Nantes,7,7,14
12450963,2025-01-20,Angers,Auxerre,4,2,6
12450961,2025-01-20,Stade de Reims,Le Havre,6,6,12
12450951,2025-01-20,Olympique de Marseille,RC Strasbourg,9,3,12
12436885,2025-01-19,Newcastle United,Bournemouth,7,6,13
12436440,2025-01-19,Brentford,Liverpool,2,15,17
12436442,2025-01-19,Leicester City,Fulham,5,2,7
12436889,2025-01-19,West Ham United,Crystal Palace,2,4,6
12436443,2025-01-19,Arsenal,Aston Villa,10,1,11
12436448,2025-01-19,Everton,Tottenham Hotspur,3,8,11
12436883,2025-01-19,Manchester United,Brighton & Hove Albion,4,2,6
12436887,2025-01-19,Nottingham Forest,Southampton,2,8,10
12436439,2025-01-19,Ipswich Town,Manchester City,4,7,11
12504434,2025-01-19,Bologna,Monza,4,0,4
12504427,2025-01-19,Juventus,Milan,5,5,10
12504426,2025-01-19,Atalanta,Napoli,3,1,4
12504425,2025-01-19,Fiorentina,Torino,9,2,11
12504429,2025-01-19,Cagliari,Lecce,6,1,7
12504423,2025-01-19,Parma,Venezia,8,2,10
12504418,2025-01-19,Hellas Verona,Lazio,5,6,11
12504421,2025-01-19,Inter,Empoli,7,3,10
12437827,2025-01-19,Girona FC,Sevilla,7,4,11
12437837,2025-01-19,Leganés,Atlético Madrid,2,9,11
12437848,2025-01-19,Real Betis,Deportivo Alavés,2,3,5
12437838,2025-01-19,Getafe,Barcelona,2,10,12
12437834,2025-01-19,Celta Vigo,Athletic Club,3,4,7
12437845,2025-01-19,Real Madrid,Las Palmas,8,2,10
12437829,2025-01-19,Osasuna,Rayo Vallecano,6,3,9
12437844,2025-01-19,Valencia,Real Sociedad,4,7,11
12499702,2025-01-19,1. FC Heidenheim,FC St. Pauli,4,4,8
12499691,2025-01-19,FC Bayern München,VfL Wolfsburg,6,2,8
12499715,2025-01-19,Holstein Kiel,TSG Hoffenheim,4,3,7
12499689,2025-01-19,VfB Stuttgart,SC Freiburg,4,1,5
12499712,2025-01-19,VfL Bochum 1848,RB Leipzig,6,3,9
12499685,2025-01-19,Bayer 04 Leverkusen,Borussia M'gladbach,7,6,13
12499708,2025-01-19,1. FC Union Berlin,1. FSV Mainz 05,2,2,4
12499704,2025-01-19,SV Werder Bremen,FC Augsburg,6,2,8
12450952,2025-01-19,RC Lens,Paris Saint-Germain,6,1,7
12450965,2025-01-19,Stade Rennais,Stade Brestois,4,4,8
12450954,2025-01-19,Olympique Lyonnais,Toulouse,8,5,13
12450957,2025-01-19,Saint-Étienne,Nantes,7,7,14
12450963,2025-01-19,Angers,Auxerre,4,2,6
12450961,2025-01-19,Stade de Reims,Le Havre,6,6,12
12450951,2025-01-19,Olympique de Marseille,RC Strasbourg,9,3,12
12436885,2025-01-18,Newcastle United,Bournemouth,7,6,13
12436440,2025-01-18,Brentford,Liverpool,2,15,17
12436442,2025-01-18,Leicester City,Fulham,5,2,7
12436889,2025-01-18,West Ham United,Crystal Palace,2,4,6
12436443,2025-01-18,Arsenal,Aston Villa,10,1,11
12504424,2025-01-18,Roma,Genoa,3,2,5
12504434,2025-01-18,Bologna,Monza,4,0,4
12504427,2025-01-18,Juventus,Milan,5,5,10
12504426,2025-01-18,Atalanta,Napoli,3,1,4
12504425,2025-01-18,Fiorentina,Torino,9,2,11
12437831,2025-01-18,Espanyol,Real Valladolid,1,7,8
12437827,2025-01-18,Girona FC,Sevilla,7,4,11
12437837,2025-01-18,Leganés,Atlético Madrid,2,9,11
12437848,2025-01-18,Real Betis,Deportivo Alavés,2,3,5
12437838,2025-01-18,Getafe,Barcelona,2,10,12
12499695,2025-01-18,Eintracht Frankfurt,Borussia Dortmund,5,7,12
12499702,2025-01-18,1. FC Heidenheim,FC St. Pauli,4,4,8
12499691,2025-01-18,FC Bayern München,VfL Wolfsburg,6,2,8
12499715,2025-01-18,Holstein Kiel,TSG Hoffenheim,4,3,7
12499689,2025-01-18,VfB Stuttgart,SC Freiburg,4,1,5
12499712,2025-01-18,VfL Bochum 1848,RB Leipzig,6,3,9
12499685,2025-01-18,Bayer 04 Leverkusen,Borussia M'gladbach,7,6,13
12450959,2025-01-18,Montpellier,AS Monaco,4,16,20
12450953,2025-01-18,Lille,Nice,7,7,14
12450952,2025-01-18,RC Lens,Paris Saint-Germain,6,1,7
12450965,2025-01-18,Stade Rennais,Stade Brestois,4,4,8
12450954,2025-01-18,Olympique Lyonnais,Toulouse,8,5,13
12436524,2025-01-17,Ipswich Town,Brighton & Hove Albion,1,9,10
12436516,2025-01-17,Manchester United,Southampton,4,4,8
12504424,2025-01-17,Roma,Genoa,3,2,5
12437831,2025-01-17,Espanyol,Real Valladolid,1,7,8
12499695,2025-01-17,Eintracht Frankfurt,Borussia Dortmund,5,7,12
12450959,2025-01-17,Montpellier,AS Monaco,4,16,20
12450953,2025-01-17,Lille,Nice,7,7,14
12436434,2025-01-16,Everton,Aston Villa,8,5,13
12436527,2025-01-16,Leicester City,Crystal Palace,4,3,7
12436529,2025-01-16,Newcastle United,Wolverhampton,4,2,6
12436511,2025-01-16,Arsenal,Tottenham Hotspur,10,4,14
12436524,2025-01-16,Ipswich Town,Brighton & Hove Albion,1,9,10
12436516,2025-01-16,Manchester United,Southampton,4,4,8
12504620,2025-01-16,Inter,Bologna,3,3,6
12499678,2025-01-16,VfL Bochum 1848,FC St. Pauli,6,7,13
12499675,2025-01-16,1. FC Union Berlin,FC Augsburg,7,4,11
12499661,2025-01-16,FC Bayern München,TSG Hoffenheim,13,1,14
12499667,2025-01-16,SV Werder Bremen,1. FC Heidenheim,4,2,6
12499657,2025-01-16,VfB Stuttgart,RB Leipzig,5,0,5
12436436,2025-01-15,Brentford,Manchester City,4,5,9
12436531,2025-01-15,Chelsea,Bournemouth,9,3,12
12436509,2025-01-15,West Ham United,Fulham,0,3,3
12436526,2025-01-15,Nottingham Forest,Liverpool,0,9,9
12436434,2025-01-15,Everton,Aston Villa,8,5,13
12436527,2025-01-15,Leicester City,Crystal Palace,4,3,7
12436529,2025-01-15,Newcastle United,Wolverhampton,4,2,6
12436511,2025-01-15,Arsenal,Tottenham Hotspur,10,4,14
12504625,2025-01-15,Como,Milan,2,4,6
12504624,2025-01-15,Atalanta,Juventus,3,3,6
12504620,2025-01-15,Inter,Bologna,3,3,6
12499682,2025-01-15,Holstein Kiel,Borussia Dortmund,1,9,10
12499653,2025-01-15,Bayer 04 Leverkusen,1. FSV Mainz 05,8,4,12
12499665,2025-01-15,Eintracht Frankfurt,SC Freiburg,8,1,9
12499672,2025-01-15,VfL Wolfsburg,Borussia M'gladbach,4,7,11
12499678,2025-01-15,VfL Bochum 1848,FC St. Pauli,6,7,13
12499675,2025-01-15,1. FC Union Berlin,FC Augsburg,7,4,11
12499661,2025-01-15,FC Bayern München,TSG Hoffenheim,13,1,14
12499667,2025-01-15,SV Werder Bremen,1. FC Heidenheim,4,2,6
12499657,2025-01-15,VfB Stuttgart,RB Leipzig,5,0,5
12436436,2025-01-14,Brentford,Manchester City,4,5,9
12436531,2025-01-14,Chelsea,Bournemouth,9,3,12
12436509,2025-01-14,West Ham United,Fulham,0,3,3
12436526,2025-01-14,Nottingham Forest,Liverpool,0,9,9
12504435,2025-01-14,Monza,Fiorentina,2,4,6
12504625,2025-01-14,Como,Milan,2,4,6
12504624,2025-01-14,Atalanta,Juventus,3,3,6
12437807,2025-01-14,Real Sociedad,Villarreal,3,7,10
12499682,2025-01-14,Holstein Kiel,Borussia Dortmund,1,9,10
12499653,2025-01-14,Bayer 04 Leverkusen,1. FSV Mainz 05,8,4,12
12499665,2025-01-14,Eintracht Frankfurt,SC Freiburg,8,1,9
12499672,2025-01-14,VfL Wolfsburg,Borussia M'gladbach,4,7,11
12504436,2025-01-13,Genoa,Parma,6,9,15
12504432,2025-01-13,Venezia,Inter,4,5,9
12504438,2025-01-13,Bologna,Roma,5,4,9
12504433,2025-01-13,Napoli,Hellas Verona,8,1,9
12504435,2025-01-13,Monza,Fiorentina,2,4,6
12437823,2025-01-13,Las Palmas,Getafe,4,5,9
12437804,2025-01-13,Atlético Madrid,Osasuna,4,0,4
12437807,2025-01-13,Real Sociedad,Villarreal,3,7,10
12499622,2025-01-13,RB Leipzig,SV Werder Bremen,4,1,5
12499640,2025-01-13,FC Augsburg,VfB Stuttgart,3,9,12
12450946,2025-01-13,Le Havre,RC Lens,3,8,11
12450947,2025-01-13,Montpellier,Angers,3,3,6
12450942,2025-01-13,Toulouse,RC Strasbourg,3,2,5
12450949,2025-01-13,Paris Saint-Germain,Saint-Étienne,7,3,10
12504439,2025-01-12,Empoli,Lecce,9,2,11
12504428,2025-01-12,Udinese,Atalanta,5,3,8
12504431,2025-01-12,Torino,Juventus,9,1,10
12504437,2025-01-12,Milan,Cagliari,9,1,10
12504436,2025-01-12,Genoa,Parma,6,9,15
12504432,2025-01-12,Venezia,Inter,4,5,9
12504438,2025-01-12,Bologna,Roma,5,4,9
12504433,2025-01-12,Napoli,Hellas Verona,8,1,9
12437812,2025-01-12,Deportivo Alavés,Girona FC,6,3,9
12437819,2025-01-12,Real Valladolid,Real Betis,1,8,9
12437814,2025-01-12,Espanyol,Leganés,8,4,12
12437809,2025-01-12,Sevilla,Valencia,10,1,11
12437823,2025-01-12,Las Palmas,Getafe,4,5,9
12437804,2025-01-12,Atlético Madrid,Osasuna,4,0,4
12499632,2025-01-12,1. FC Heidenheim,1. FC Union Berlin,5,4,9
12499643,2025-01-12,1. FSV Mainz 05,VfL Bochum 1848,5,6,11
12499650,2025-01-12,FC St. Pauli,Eintracht Frankfurt,3,3,6
12499637,2025-01-12,SC Freiburg,Holstein Kiel,7,1,8
12499629,2025-01-12,TSG Hoffenheim,VfL Wolfsburg,4,8,12
12499647,2025-01-12,Borussia M'gladbach,FC Bayern München,4,10,14
12499622,2025-01-12,RB Leipzig,SV Werder Bremen,4,1,5
12499640,2025-01-12,FC Augsburg,VfB Stuttgart,3,9,12
12450948,2025-01-12,Stade Brestois,Olympique Lyonnais,4,7,11
12450945,2025-01-12,Stade de Reims,Nice,6,3,9
12450950,2025-01-12,Stade Rennais,Olympique de Marseille,2,3,5
12450946,2025-01-12,Le Havre,RC Lens,3,8,11
12450947,2025-01-12,Montpellier,Angers,3,3,6
12450942,2025-01-12,Toulouse,RC Strasbourg,3,2,5
12450949,2025-01-12,Paris Saint-Germain,Saint-Étienne,7,3,10
12504440,2025-01-11,Lazio,Como,7,7,14
12504439,2025-01-11,Empoli,Lecce,9,2,11
12504428,2025-01-11,Udinese,Atalanta,5,3,8
12504431,2025-01-11,Torino,Juventus,9,1,10
12504437,2025-01-11,Milan,Cagliari,9,1,10
12504436,2025-01-11,Genoa,Parma,6,9,15
12437822,2025-01-11,Rayo Vallecano,Celta Vigo,3,3,6
12437812,2025-01-11,Deportivo Alavés,Girona FC,6,3,9
12437819,2025-01-11,Real Valladolid,Real Betis,1,8,9
12437814,2025-01-11,Espanyol,Leganés,8,4,12
12437809,2025-01-11,Sevilla,Valencia,10,1,11
12499626,2025-01-11,Borussia Dortmund,Bayer 04 Leverkusen,6,1,7
12499632,2025-01-11,1. FC Heidenheim,1. FC Union Berlin,5,4,9
12499643,2025-01-11,1. FSV Mainz 05,VfL Bochum 1848,5,6,11
12499650,2025-01-11,FC St. Pauli,Eintracht Frankfurt,3,3,6
12499637,2025-01-11,SC Freiburg,Holstein Kiel,7,1,8
12499629,2025-01-11,TSG Hoffenheim,VfL Wolfsburg,4,8,12
12499647,2025-01-11,Borussia M'gladbach,FC Bayern München,4,10,14
12450943,2025-01-11,Nantes,AS Monaco,3,11,14
12450944,2025-01-11,Auxerre,Lille,6,10,16
12450948,2025-01-11,Stade Brestois,Olympique Lyonnais,4,7,11
12450945,2025-01-11,Stade de Reims,Nice,6,3,9
12450950,2025-01-11,Stade Rennais,Olympique de Marseille,2,3,5
12504440,2025-01-10,Lazio,Como,7,7,14
12437822,2025-01-10,Rayo Vallecano,Celta Vigo,3,3,6
12499626,2025-01-10,Borussia Dortmund,Bayer 04 Leverkusen,6,1,7
12450943,2025-01-10,Nantes,AS Monaco,3,11,14
12450944,2025-01-10,Auxerre,Lille,6,10,16
12436437,2025-01-07,Wolverhampton,Nottingham Forest,5,3,8
12436525,2025-01-06,Fulham,Ipswich Town,9,2,11
12436514,2025-01-06,Liverpool,Manchester United,6,9,15
12436437,2025-01-06,Wolverhampton,Nottingham Forest,5,3,8
12504622,2025-01-06,Monza,Cagliari,1,3,4
12504626,2025-01-06,Lecce,Genoa,9,4,13
12504617,2025-01-06,Torino,Parma,8,7,15
12504618,2025-01-06,Roma,Lazio,3,10,13
12450937,2025-01-06,Angers,Stade Brestois,2,4,6
12450935,2025-01-06,RC Lens,Toulouse,7,1,8
12450940,2025-01-06,RC Strasbourg,Auxerre,4,3,7
12450939,2025-01-06,Olympique de Marseille,Le Havre,4,0,4
12436519,2025-01-05,Tottenham Hotspur,Newcastle United,9,10,19
12436523,2025-01-05,Aston Villa,Leicester City,6,2,8
12436518,2025-01-05,Bournemouth,Everton,9,3,12
12436419,2025-01-05,Crystal Palace,Chelsea,6,6,12
12436508,2025-01-05,Manchester City,West Ham United,7,1,8
12436520,2025-01-05,Southampton,Brentford,2,2,4
12436528,2025-01-05,Brighton & Hove Albion,Arsenal,2,5,7
12436525,2025-01-05,Fulham,Ipswich Town,9,2,11
12436514,2025-01-05,Liverpool,Manchester United,6,9,15
12504619,2025-01-05,Venezia,Empoli,2,8,10
12504628,2025-01-05,Fiorentina,Napoli,4,2,6
12504623,2025-01-05,Hellas Verona,Udinese,7,3,10
12504622,2025-01-05,Monza,Cagliari,1,3,4
12504626,2025-01-05,Lecce,Genoa,9,4,13
12504617,2025-01-05,Torino,Parma,8,7,15
12504618,2025-01-05,Roma,Lazio,3,10,13
12450936,2025-01-05,Saint-Étienne,Stade de Reims,6,9,15
12450938,2025-01-05,Lille,Nantes,2,0,2
12450934,2025-01-05,Olympique Lyonnais,Montpellier,3,5,8
12450937,2025-01-05,Angers,Stade Brestois,2,4,6
12450935,2025-01-05,RC Lens,Toulouse,7,1,8
12450940,2025-01-05,RC Strasbourg,Auxerre,4,3,7
12450939,2025-01-05,Olympique de Marseille,Le Havre,4,0,4
12436519,2025-01-04,Tottenham Hotspur,Newcastle United,9,10,19
12436523,2025-01-04,Aston Villa,Leicester City,6,2,8
12436518,2025-01-04,Bournemouth,Everton,9,3,12
12436419,2025-01-04,Crystal Palace,Chelsea,6,6,12
12436508,2025-01-04,Manchester City,West Ham United,7,1,8
12436520,2025-01-04,Southampton,Brentford,2,2,4
12436528,2025-01-04,Brighton & Hove Albion,Arsenal,2,5,7
12504619,2025-01-04,Venezia,Empoli,2,8,10
12504628,2025-01-04,Fiorentina,Napoli,4,2,6
12504623,2025-01-04,Hellas Verona,Udinese,7,3,10
12504622,2025-01-04,Monza,Cagliari,1,3,4
13199638,2025-01-04,Valencia,Real Madrid,2,5,7
12450941,2025-01-04,Nice,Stade Rennais,3,3,6
12450936,2025-01-04,Saint-Étienne,Stade de Reims,6,9,15
12450938,2025-01-04,Lille,Nantes,2,0,2
12450934,2025-01-04,Olympique Lyonnais,Montpellier,3,5,8
13199638,2025-01-03,Valencia,Real Madrid,2,5,7
12450941,2025-01-03,Nice,Stade Rennais,3,3,6
12436410,2025-01-02,Brentford,Arsenal,4,3,7
12436410,2025-01-01,Brentford,Arsenal,4,3,7
12436530,2024-12-31,Aston Villa,Brighton & Hove Albion,12,3,15
12436510,2024-12-31,Ipswich Town,Chelsea,4,7,11
12436522,2024-12-31,Manchester United,Newcastle United,2,3,5
12504639,2024-12-31,Como,Lecce,4,4,8
12504638,2024-12-31,Bologna,Hellas Verona,11,5,16
12436512,2024-12-30,Leicester City,Manchester City,4,4,8
12436532,2024-12-30,Crystal Palace,Southampton,8,7,15
12436517,2024-12-30,Everton,Nottingham Forest,5,4,9
12436515,2024-12-30,Fulham,Bournemouth,1,7,8
12436521,2024-12-30,Tottenham Hotspur,Wolverhampton,5,5,10
12436513,2024-12-30,West Ham United,Liverpool,2,6,8
12436530,2024-12-30,Aston Villa,Brighton & Hove Albion,12,3,15
12436510,2024-12-30,Ipswich Town,Chelsea,4,7,11
12436522,2024-12-30,Manchester United,Newcastle United,2,3,5
12504627,2024-12-30,Udinese,Torino,4,3,7
12504629,2024-12-30,Napoli,Venezia,14,4,18
12504635,2024-12-30,Juventus,Fiorentina,7,2,9
12504631,2024-12-30,Milan,Roma,6,5,11
12504639,2024-12-30,Como,Lecce,4,4,8
12504638,2024-12-30,Bologna,Hellas Verona,11,5,16
12436512,2024-12-29,Leicester City,Manchester City,4,4,8
12436532,2024-12-29,Crystal Palace,Southampton,8,7,15
12436517,2024-12-29,Everton,Nottingham Forest,5,4,9
12436515,2024-12-29,Fulham,Bournemouth,1,7,8
12436521,2024-12-29,Tottenham Hotspur,Wolverhampton,5,5,10
12436513,2024-12-29,West Ham United,Liverpool,2,6,8
12504632,2024-12-29,Empoli,Genoa,7,4,11
12504636,2024-12-29,Parma,Monza,4,6,10
12504633,2024-12-29,Cagliari,Inter,5,7,12
12504630,2024-12-29,Lazio,Atalanta,2,7,9
12504627,2024-12-29,Udinese,Torino,4,3,7
12504629,2024-12-29,Napoli,Venezia,14,4,18
12504635,2024-12-29,Juventus,Fiorentina,7,2,9
12504631,2024-12-29,Milan,Roma,6,5,11
12436475,2024-12-28,Brighton & Hove Albion,Brentford,5,3,8
12436472,2024-12-28,Arsenal,Ipswich Town,5,1,6
12504632,2024-12-28,Empoli,Genoa,7,4,11
12504636,2024-12-28,Parma,Monza,4,6,10
12504633,2024-12-28,Cagliari,Inter,5,7,12
12504630,2024-12-28,Lazio,Atalanta,2,7,9
12504627,2024-12-28,Udinese,Torino,4,3,7
12436481,2024-12-27,Manchester City,Everton,8,5,13
12436476,2024-12-27,Bournemouth,Crystal Palace,5,2,7
12436473,2024-12-27,Chelsea,Fulham,3,1,4
12436477,2024-12-27,Newcastle United,Aston Villa,9,6,15
12436479,2024-12-27,Nottingham Forest,Tottenham Hotspur,2,7,9
12436480,2024-12-27,Southampton,West Ham United,2,2,4
12436482,2024-12-27,Wolverhampton,Manchester United,4,4,8
12436474,2024-12-27,Liverpool,Leicester City,14,1,15
12436475,2024-12-27,Brighton & Hove Albion,Brentford,5,3,8
12436472,2024-12-27,Arsenal,Ipswich Town,5,1,6
12436481,2024-12-26,Manchester City,Everton,8,5,13
12436476,2024-12-26,Bournemouth,Crystal Palace,5,2,7
12436473,2024-12-26,Chelsea,Fulham,3,1,4
12436477,2024-12-26,Newcastle United,Aston Villa,9,6,15
12436479,2024-12-26,Nottingham Forest,Tottenham Hotspur,2,7,9
12436480,2024-12-26,Southampton,West Ham United,2,2,4
12436482,2024-12-26,Wolverhampton,Manchester United,4,4,8
12436474,2024-12-26,Liverpool,Leicester City,14,1,15
12504643,2024-12-24,Fiorentina,Udinese,10,2,12
12504644,2024-12-24,Inter,Como,7,1,8
12436466,2024-12-23,Everton,Chelsea,2,5,7
12436468,2024-12-23,Fulham,Southampton,6,5,11
12436469,2024-12-23,Leicester City,Wolverhampton,6,1,7
12436470,2024-12-23,Manchester United,Bournemouth,13,1,14
12436471,2024-12-23,Tottenham Hotspur,Liverpool,7,5,12
12504654,2024-12-23,Roma,Parma,5,2,7
12504637,2024-12-23,Venezia,Cagliari,4,8,12
12504653,2024-12-23,Atalanta,Empoli,6,3,9
12504642,2024-12-23,Monza,Juventus,3,7,10
12504643,2024-12-23,Fiorentina,Udinese,10,2,12
12504644,2024-12-23,Inter,Como,7,1,8
12437797,2024-12-23,Valencia,Deportivo Alavés,5,4,9
12437788,2024-12-23,Real Madrid,Sevilla,6,6,12
12437799,2024-12-23,Las Palmas,Espanyol,2,2,4
12437790,2024-12-23,Leganés,Villarreal,1,5,6
12437778,2024-12-23,Real Betis,Rayo Vallecano,5,5,10
12499616,2024-12-23,VfL Bochum 1848,1. FC Heidenheim,5,2,7
12499613,2024-12-23,VfL Wolfsburg,Borussia Dortmund,10,4,14
12436453,2024-12-22,Aston Villa,Manchester City,5,4,9
12436463,2024-12-22,Brentford,Nottingham Forest,9,5,14
12436467,2024-12-22,Ipswich Town,Newcastle United,2,1,3
12436478,2024-12-22,West Ham United,Brighton & Hove Albion,8,4,12
12436464,2024-12-22,Crystal Palace,Arsenal,3,3,6
12436466,2024-12-22,Everton,Chelsea,2,5,7
12436468,2024-12-22,Fulham,Southampton,6,5,11
12436469,2024-12-22,Leicester City,Wolverhampton,6,1,7
12436470,2024-12-22,Manchester United,Bournemouth,13,1,14
12436471,2024-12-22,Tottenham Hotspur,Liverpool,7,5,12
12504640,2024-12-22,Torino,Bologna,4,0,4
12504646,2024-12-22,Genoa,Napoli,5,6,11
12504641,2024-12-22,Lecce,Lazio,6,6,12
12504654,2024-12-22,Roma,Parma,5,2,7
12504637,2024-12-22,Venezia,Cagliari,4,8,12
12504653,2024-12-22,Atalanta,Empoli,6,3,9
12504642,2024-12-22,Monza,Juventus,3,7,10
12437783,2024-12-22,Getafe,Mallorca,3,0,3
12437780,2024-12-22,Celta Vigo,Real Sociedad,4,7,11
12437793,2024-12-22,Osasuna,Athletic Club,4,3,7
12437794,2024-12-22,Barcelona,Atlético Madrid,11,3,14
12437797,2024-12-22,Valencia,Deportivo Alavés,5,4,9
12437788,2024-12-22,Real Madrid,Sevilla,6,6,12
12437799,2024-12-22,Las Palmas,Espanyol,2,2,4
12437790,2024-12-22,Leganés,Villarreal,1,5,6
12437778,2024-12-22,Real Betis,Rayo Vallecano,5,5,10
12499603,2024-12-22,Eintracht Frankfurt,1. FSV Mainz 05,17,2,19
12499619,2024-12-22,Holstein Kiel,FC Augsburg,3,8,11
12499609,2024-12-22,SV Werder Bremen,1. FC Union Berlin,4,9,13
12499606,2024-12-22,TSG Hoffenheim,Borussia M'gladbach,8,4,12
12499596,2024-12-22,VfB Stuttgart,FC St. Pauli,9,1,10
12499593,2024-12-22,Bayer 04 Leverkusen,SC Freiburg,4,2,6
12499616,2024-12-22,VfL Bochum 1848,1. FC Heidenheim,5,2,7
12499613,2024-12-22,VfL Wolfsburg,Borussia Dortmund,10,4,14
12436453,2024-12-21,Aston Villa,Manchester City,5,4,9
12436463,2024-12-21,Brentford,Nottingham Forest,9,5,14
12436467,2024-12-21,Ipswich Town,Newcastle United,2,1,3
12436478,2024-12-21,West Ham United,Brighton & Hove Albion,8,4,12
12436464,2024-12-21,Crystal Palace,Arsenal,3,3,6
12504645,2024-12-21,Hellas Verona,Milan,3,8,11
12504640,2024-12-21,Torino,Bologna,4,0,4
12504646,2024-12-21,Genoa,Napoli,5,6,11
12504641,2024-12-21,Lecce,Lazio,6,6,12
12504654,2024-12-21,Roma,Parma,5,2,7
12437785,2024-12-21,Girona FC,Real Valladolid,9,1,10
12437783,2024-12-21,Getafe,Mallorca,3,0,3
12437780,2024-12-21,Celta Vigo,Real Sociedad,4,7,11
12437793,2024-12-21,Osasuna,Athletic Club,4,3,7
12437794,2024-12-21,Barcelona,Atlético Madrid,11,3,14
12499599,2024-12-21,FC Bayern München,RB Leipzig,8,1,9
12499603,2024-12-21,Eintracht Frankfurt,1. FSV Mainz 05,17,2,19
12499619,2024-12-21,Holstein Kiel,FC Augsburg,3,8,11
12499609,2024-12-21,SV Werder Bremen,1. FC Union Berlin,4,9,13
12499606,2024-12-21,TSG Hoffenheim,Borussia M'gladbach,8,4,12
12499596,2024-12-21,VfB Stuttgart,FC St. Pauli,9,1,10
12499593,2024-12-21,Bayer 04 Leverkusen,SC Freiburg,4,2,6
12504645,2024-12-20,Hellas Verona,Milan,3,8,11
12437785,2024-12-20,Girona FC,Real Valladolid,9,1,10
12499599,2024-12-20,FC Bayern München,RB Leipzig,8,1,9
13128822,2024-12-19,Espanyol,Valencia,4,7,11
13096804,2024-12-19,Villarreal,Rayo Vallecano,7,7,14
12450933,2024-12-19,AS Monaco,Paris Saint-Germain,1,9,10
13128822,2024-12-18,Espanyol,Valencia,4,7,11
13096804,2024-12-18,Villarreal,Rayo Vallecano,7,7,14
12450933,2024-12-18,AS Monaco,Paris Saint-Germain,1,9,10
12436465,2024-12-17,Bournemouth,West Ham United,12,6,18
12504657,2024-12-17,Lazio,Inter,4,2,6
12436457,2024-12-16,Brighton & Hove Albion,Crystal Palace,8,5,13
12436451,2024-12-16,Manchester City,Manchester United,8,2,10
12436461,2024-12-16,Chelsea,Brentford,8,5,13
12436458,2024-12-16,Southampton,Tottenham Hotspur,2,5,7
12436465,2024-12-16,Bournemouth,West Ham United,12,6,18
12504660,2024-12-16,Lecce,Monza,2,7,9
12504656,2024-12-16,Bologna,Fiorentina,1,3,4
12504647,2024-12-16,Parma,Hellas Verona,5,2,7
12504658,2024-12-16,Como,Roma,6,5,11
12504652,2024-12-16,Milan,Genoa,9,2,11
12504657,2024-12-16,Lazio,Inter,4,2,6
12437755,2024-12-16,Atlético Madrid,Getafe,8,3,11
12437762,2024-12-16,Deportivo Alavés,Athletic Club,2,4,6
12437776,2024-12-16,Real Sociedad,Las Palmas,8,6,14
12437767,2024-12-16,Villarreal,Real Betis,5,5,10
12437757,2024-12-16,Barcelona,Leganés,8,2,10
12499570,2024-12-16,1. FC Heidenheim,VfB Stuttgart,9,6,15
12499551,2024-12-16,Borussia Dortmund,TSG Hoffenheim,3,9,12
12499548,2024-12-16,RB Leipzig,Eintracht Frankfurt,6,7,13
12450929,2024-12-16,Montpellier,Nice,9,4,13
12450925,2024-12-16,Le Havre,RC Strasbourg,3,2,5
12450930,2024-12-16,Stade Brestois,Nantes,0,5,5
12450924,2024-12-16,Stade Rennais,Angers,2,1,3
12450932,2024-12-16,Paris Saint-Germain,Olympique Lyonnais,4,3,7
12436438,2024-12-15,Arsenal,Everton,8,2,10
12436446,2024-12-15,Liverpool,Fulham,5,4,9
12436460,2024-12-15,Newcastle United,Leicester City,5,2,7
12436456,2024-12-15,Wolverhampton,Ipswich Town,7,3,10
12436447,2024-12-15,Nottingham Forest,Aston Villa,4,3,7
12436457,2024-12-15,Brighton & Hove Albion,Crystal Palace,8,5,13
12436451,2024-12-15,Manchester City,Manchester United,8,2,10
12436461,2024-12-15,Chelsea,Brentford,8,5,13
12436458,2024-12-15,Southampton,Tottenham Hotspur,2,5,7
12504651,2024-12-15,Cagliari,Atalanta,2,5,7
12504648,2024-12-15,Udinese,Napoli,3,9,12
12504650,2024-12-15,Juventus,Venezia,7,4,11
12504660,2024-12-15,Lecce,Monza,2,7,9
12504656,2024-12-15,Bologna,Fiorentina,1,3,4
12504647,2024-12-15,Parma,Hellas Verona,5,2,7
12504658,2024-12-15,Como,Roma,6,5,11
12504652,2024-12-15,Milan,Genoa,9,2,11
12437764,2024-12-15,Espanyol,Osasuna,5,4,9
12437771,2024-12-15,Mallorca,Girona FC,2,4,6
12437769,2024-12-15,Sevilla,Celta Vigo,3,4,7
12437759,2024-12-15,Rayo Vallecano,Real Madrid,4,3,7
12437755,2024-12-15,Atlético Madrid,Getafe,8,3,11
12437762,2024-12-15,Deportivo Alavés,Athletic Club,2,4,6
12437776,2024-12-15,Real Sociedad,Las Palmas,8,6,14
12437767,2024-12-15,Villarreal,Real Betis,5,5,10
12437757,2024-12-15,Barcelona,Leganés,8,2,10
12499580,2024-12-15,1. FSV Mainz 05,FC Bayern München,3,2,5
12499583,2024-12-15,Borussia M'gladbach,Holstein Kiel,5,2,7
12499576,2024-12-15,FC Augsburg,Bayer 04 Leverkusen,4,9,13
12499590,2024-12-15,FC St. Pauli,SV Werder Bremen,4,5,9
12499570,2024-12-15,1. FC Heidenheim,VfB Stuttgart,9,6,15
12499551,2024-12-15,Borussia Dortmund,TSG Hoffenheim,3,9,12
12499548,2024-12-15,RB Leipzig,Eintracht Frankfurt,6,7,13
12450931,2024-12-15,Olympique de Marseille,Lille,3,8,11
12450927,2024-12-15,Auxerre,RC Lens,3,5,8
12450926,2024-12-15,Stade de Reims,AS Monaco,1,4,5
12450929,2024-12-15,Montpellier,Nice,9,4,13
12450925,2024-12-15,Le Havre,RC Strasbourg,3,2,5
12450930,2024-12-15,Stade Brestois,Nantes,0,5,5
12450924,2024-12-15,Stade Rennais,Angers,2,1,3
12450932,2024-12-15,Paris Saint-Germain,Olympique Lyonnais,4,3,7
12436438,2024-12-14,Arsenal,Everton,8,2,10
12436446,2024-12-14,Liverpool,Fulham,5,4,9
12436460,2024-12-14,Newcastle United,Leicester City,5,2,7
12436456,2024-12-14,Wolverhampton,Ipswich Town,7,3,10
12436447,2024-12-14,Nottingham Forest,Aston Villa,4,3,7
12504649,2024-12-14,Empoli,Torino,12,3,15
12504651,2024-12-14,Cagliari,Atalanta,2,5,7
12504648,2024-12-14,Udinese,Napoli,3,9,12
12504650,2024-12-14,Juventus,Venezia,7,4,11
12504660,2024-12-14,Lecce,Monza,2,7,9
12437773,2024-12-14,Real Valladolid,Valencia,1,7,8
12437764,2024-12-14,Espanyol,Osasuna,5,4,9
12437771,2024-12-14,Mallorca,Girona FC,2,4,6
12437769,2024-12-14,Sevilla,Celta Vigo,3,4,7
12437759,2024-12-14,Rayo Vallecano,Real Madrid,4,3,7
12499573,2024-12-14,SC Freiburg,VfL Wolfsburg,5,6,11
12499580,2024-12-14,1. FSV Mainz 05,FC Bayern München,3,2,5
12499583,2024-12-14,Borussia M'gladbach,Holstein Kiel,5,2,7
12499576,2024-12-14,FC Augsburg,Bayer 04 Leverkusen,4,9,13
12499590,2024-12-14,FC St. Pauli,SV Werder Bremen,4,5,9
12450928,2024-12-14,Toulouse,Saint-Étienne,2,3,5
12450931,2024-12-14,Olympique de Marseille,Lille,3,8,11
12450927,2024-12-14,Auxerre,RC Lens,3,5,8
12450926,2024-12-14,Stade de Reims,AS Monaco,1,4,5
12504649,2024-12-13,Empoli,Torino,12,3,15
12437773,2024-12-13,Real Valladolid,Valencia,1,7,8
12499573,2024-12-13,SC Freiburg,VfL Wolfsburg,5,6,11
12450928,2024-12-13,Toulouse,Saint-Étienne,2,3,5
12436454,2024-12-10,West Ham United,Wolverhampton,11,0,11
12504662,2024-12-10,Monza,Udinese,10,1,11
12437752,2024-12-10,Getafe,Espanyol,3,3,6
12436459,2024-12-09,Fulham,Arsenal,0,6,6
12436462,2024-12-09,Ipswich Town,Bournemouth,6,13,19
12436444,2024-12-09,Leicester City,Brighton & Hove Albion,4,5,9
12436441,2024-12-09,Tottenham Hotspur,Chelsea,5,10,15
12436454,2024-12-09,West Ham United,Wolverhampton,11,0,11
12504668,2024-12-09,Fiorentina,Cagliari,6,4,10
12504664,2024-12-09,Hellas Verona,Empoli,5,8,13
12504655,2024-12-09,Venezia,Como,5,9,14
12504661,2024-12-09,Napoli,Lazio,6,2,8
12504662,2024-12-09,Monza,Udinese,10,1,11
12437742,2024-12-09,Leganés,Real Sociedad,5,3,8
12437731,2024-12-09,Athletic Club,Villarreal,3,3,6
12437750,2024-12-09,Osasuna,Deportivo Alavés,8,3,11
12437733,2024-12-09,Atlético Madrid,Sevilla,5,3,8
12437752,2024-12-09,Getafe,Espanyol,3,3,6
12499521,2024-12-09,VfL Wolfsburg,1. FSV Mainz 05,3,5,8
12499511,2024-12-09,TSG Hoffenheim,SC Freiburg,6,1,7
12450919,2024-12-09,RC Lens,Montpellier,6,3,9
12450921,2024-12-09,Nantes,Stade Rennais,5,5,10
12450920,2024-12-09,RC Strasbourg,Stade de Reims,3,2,5
12450916,2024-12-09,Saint-Étienne,Olympique de Marseille,0,9,9
12436990,2024-12-08,Aston Villa,Southampton,14,1,15
12436450,2024-12-08,Brentford,Newcastle United,3,4,7
12436445,2024-12-08,Crystal Palace,Manchester City,6,8,14
12436449,2024-12-08,Manchester United,Nottingham Forest,5,3,8
12436459,2024-12-08,Fulham,Arsenal,0,6,6
12436462,2024-12-08,Ipswich Town,Bournemouth,6,13,19
12436444,2024-12-08,Leicester City,Brighton & Hove Albion,4,5,9
12436441,2024-12-08,Tottenham Hotspur,Chelsea,5,10,15
12504667,2024-12-08,Genoa,Torino,4,4,8
12504671,2024-12-08,Juventus,Bologna,1,4,5
12504659,2024-12-08,Roma,Lecce,8,1,9
12504668,2024-12-08,Fiorentina,Cagliari,6,4,10
12504664,2024-12-08,Hellas Verona,Empoli,5,8,13
12504655,2024-12-08,Venezia,Como,5,9,14
12504661,2024-12-08,Napoli,Lazio,6,2,8
12437740,2024-12-08,Las Palmas,Real Valladolid,3,3,6
12437745,2024-12-08,Real Betis,Barcelona,6,4,10
12437747,2024-12-08,Valencia,Rayo Vallecano,9,4,13
12437738,2024-12-08,Girona FC,Real Madrid,6,3,9
12437742,2024-12-08,Leganés,Real Sociedad,5,3,8
12437731,2024-12-08,Athletic Club,Villarreal,3,3,6
12437750,2024-12-08,Osasuna,Deportivo Alavés,8,3,11
12437733,2024-12-08,Atlético Madrid,Sevilla,5,3,8
12499477,2024-12-08,Bayer 04 Leverkusen,FC St. Pauli,7,4,11
12499502,2024-12-08,Eintracht Frankfurt,FC Augsburg,4,0,4
12499495,2024-12-08,FC Bayern München,1. FC Heidenheim,8,0,8
12499545,2024-12-08,Holstein Kiel,RB Leipzig,6,1,7
12499537,2024-12-08,VfL Bochum 1848,SV Werder Bremen,9,5,14
12499529,2024-12-08,Borussia M'gladbach,Borussia Dortmund,7,4,11
12499521,2024-12-08,VfL Wolfsburg,1. FSV Mainz 05,3,5,8
12499511,2024-12-08,TSG Hoffenheim,SC Freiburg,6,1,7
12450922,2024-12-08,AS Monaco,Toulouse,2,3,5
12450914,2024-12-08,Nice,Le Havre,5,8,13
12450917,2024-12-08,Angers,Olympique Lyonnais,2,7,9
12450919,2024-12-08,RC Lens,Montpellier,6,3,9
12450921,2024-12-08,Nantes,Stade Rennais,5,5,10
12450920,2024-12-08,RC Strasbourg,Stade de Reims,3,2,5
12450916,2024-12-08,Saint-Étienne,Olympique de Marseille,0,9,9
12436990,2024-12-07,Aston Villa,Southampton,14,1,15
12436450,2024-12-07,Brentford,Newcastle United,3,4,7
12436445,2024-12-07,Crystal Palace,Manchester City,6,8,14
12436449,2024-12-07,Manchester United,Nottingham Forest,5,3,8
12504670,2024-12-07,Inter,Parma,10,1,11
12504663,2024-12-07,Atalanta,Milan,7,0,7
12504667,2024-12-07,Genoa,Torino,4,4,8
12504671,2024-12-07,Juventus,Bologna,1,4,5
12504659,2024-12-07,Roma,Lecce,8,1,9
12504668,2024-12-07,Fiorentina,Cagliari,6,4,10
12437735,2024-12-07,Celta Vigo,Mallorca,3,3,6
12437740,2024-12-07,Las Palmas,Real Valladolid,3,3,6
12437745,2024-12-07,Real Betis,Barcelona,6,4,10
12437747,2024-12-07,Valencia,Rayo Vallecano,9,4,13
12437738,2024-12-07,Girona FC,Real Madrid,6,3,9
12499484,2024-12-07,VfB Stuttgart,1. FC Union Berlin,1,6,7
12499477,2024-12-07,Bayer 04 Leverkusen,FC St. Pauli,7,4,11
12499502,2024-12-07,Eintracht Frankfurt,FC Augsburg,4,0,4
12499495,2024-12-07,FC Bayern München,1. FC Heidenheim,8,0,8
12499545,2024-12-07,Holstein Kiel,RB Leipzig,6,1,7
12499537,2024-12-07,VfL Bochum 1848,SV Werder Bremen,9,5,14
12499529,2024-12-07,Borussia M'gladbach,Borussia Dortmund,7,4,11
12450918,2024-12-07,Lille,Stade Brestois,2,1,3
12450915,2024-12-07,Auxerre,Paris Saint-Germain,3,15,18
12450922,2024-12-07,AS Monaco,Toulouse,2,3,5
12450914,2024-12-07,Nice,Le Havre,5,8,13
12450917,2024-12-07,Angers,Olympique Lyonnais,2,7,9
12436955,2024-12-06,Fulham,Brighton & Hove Albion,5,6,11
13015216,2024-12-06,Bournemouth,Tottenham Hotspur,5,9,14
12504670,2024-12-06,Inter,Parma,10,1,11
12504663,2024-12-06,Atalanta,Milan,7,0,7
12437735,2024-12-06,Celta Vigo,Mallorca,3,3,6
12499484,2024-12-06,VfB Stuttgart,1. FC Union Berlin,1,6,7
12450918,2024-12-06,Lille,Stade Brestois,2,1,3
12450915,2024-12-06,Auxerre,Paris Saint-Germain,3,15,18
12436947,2024-12-05,Everton,Wolverhampton,3,4,7
12436972,2024-12-05,Manchester City,Nottingham Forest,8,2,10
12436978,2024-12-05,Newcastle United,Liverpool,5,6,11
12436984,2024-12-05,Southampton,Chelsea,5,7,12
12436935,2024-12-05,Arsenal,Manchester United,13,0,13
12436942,2024-12-05,Aston Villa,Brentford,10,5,15
12436955,2024-12-05,Fulham,Brighton & Hove Albion,5,6,11
13015216,2024-12-05,Bournemouth,Tottenham Hotspur,5,9,14
12437801,2024-12-05,Athletic Club,Real Madrid,5,2,7
12436961,2024-12-04,Ipswich Town,Crystal Palace,4,7,11
12436966,2024-12-04,Leicester City,West Ham United,3,9,12
12436947,2024-12-04,Everton,Wolverhampton,3,4,7
12436972,2024-12-04,Manchester City,Nottingham Forest,8,2,10
12436978,2024-12-04,Newcastle United,Liverpool,5,6,11
12436984,2024-12-04,Southampton,Chelsea,5,7,12
12436935,2024-12-04,Arsenal,Manchester United,13,0,13
12436942,2024-12-04,Aston Villa,Brentford,10,5,15
12437816,2024-12-04,Mallorca,Barcelona,2,5,7
12437801,2024-12-04,Athletic Club,Real Madrid,5,2,7
12436961,2024-12-03,Ipswich Town,Crystal Palace,4,7,11
12436966,2024-12-03,Leicester City,West Ham United,3,9,12
12504673,2024-12-03,Roma,Atalanta,2,4,6
12437729,2024-12-03,Sevilla,Osasuna,5,1,6
12437816,2024-12-03,Mallorca,Barcelona,2,5,7
12436498,2024-12-02,Chelsea,Aston Villa,3,4,7
12436505,2024-12-02,Manchester United,Everton,2,2,4
12436507,2024-12-02,Tottenham Hotspur,Fulham,7,11,18
12436504,2024-12-02,Liverpool,Manchester City,7,4,11
12504665,2024-12-02,Udinese,Genoa,6,4,10
12504666,2024-12-02,Parma,Lazio,4,10,14
12504669,2024-12-02,Torino,Napoli,4,7,11
12504674,2024-12-02,Lecce,Juventus,2,7,9
12504673,2024-12-02,Roma,Atalanta,2,4,6
12437727,2024-12-02,Villarreal,Girona FC,1,5,6
12437724,2024-12-02,Real Madrid,Getafe,5,3,8
12437717,2024-12-02,Rayo Vallecano,Athletic Club,1,7,8
12437722,2024-12-02,Real Sociedad,Real Betis,0,4,4
12437729,2024-12-02,Sevilla,Osasuna,5,1,6
12499448,2024-12-02,1. FSV Mainz 05,TSG Hoffenheim,8,3,11
12499399,2024-12-02,1. FC Heidenheim,Eintracht Frankfurt,6,5,11
12450910,2024-12-02,Montpellier,Lille,7,2,9
12450907,2024-12-02,Le Havre,Angers,2,4,6
12450913,2024-12-02,Olympique Lyonnais,Nice,5,4,9
12450908,2024-12-02,Toulouse,Auxerre,6,2,8
12450912,2024-12-02,Olympique de Marseille,AS Monaco,5,3,8
12436500,2024-12-01,Brentford,Leicester City,5,4,9
12436502,2024-12-01,Crystal Palace,Newcastle United,8,9,17
12436503,2024-12-01,Nottingham Forest,Ipswich Town,8,7,15
12436922,2024-12-01,Wolverhampton,Bournemouth,3,4,7
12436914,2024-12-01,West Ham United,Arsenal,2,10,12
12436498,2024-12-01,Chelsea,Aston Villa,3,4,7
12436505,2024-12-01,Manchester United,Everton,2,2,4
12436507,2024-12-01,Tottenham Hotspur,Fulham,7,11,18
12436504,2024-12-01,Liverpool,Manchester City,7,4,11
12504681,2024-12-01,Como,Monza,11,4,15
12504672,2024-12-01,Milan,Empoli,7,3,10
12504677,2024-12-01,Bologna,Venezia,1,0,1
12504665,2024-12-01,Udinese,Genoa,6,4,10
12504666,2024-12-01,Parma,Lazio,4,10,14
12504669,2024-12-01,Torino,Napoli,4,7,11
12504674,2024-12-01,Lecce,Juventus,2,7,9
12437708,2024-12-01,Barcelona,Las Palmas,7,0,7
12437712,2024-12-01,Deportivo Alavés,Leganés,13,8,21
12437715,2024-12-01,Espanyol,Celta Vigo,2,5,7
12437720,2024-12-01,Real Valladolid,Atlético Madrid,3,5,8
12437727,2024-12-01,Villarreal,Girona FC,1,5,6
12437724,2024-12-01,Real Madrid,Getafe,5,3,8
12437717,2024-12-01,Rayo Vallecano,Athletic Club,1,7,8
12437722,2024-12-01,Real Sociedad,Real Betis,0,4,4
12499457,2024-12-01,1. FC Union Berlin,Bayer 04 Leverkusen,1,3,4
12499436,2024-12-01,FC Augsburg,VfL Bochum 1848,6,1,7
12499836,2024-12-01,RB Leipzig,VfL Wolfsburg,7,3,10
12499424,2024-12-01,SC Freiburg,Borussia M'gladbach,4,6,10
12499411,2024-12-01,SV Werder Bremen,VfB Stuttgart,11,2,13
12499387,2024-12-01,Borussia Dortmund,FC Bayern München,2,3,5
12499448,2024-12-01,1. FSV Mainz 05,TSG Hoffenheim,8,3,11
12499399,2024-12-01,1. FC Heidenheim,Eintracht Frankfurt,6,5,11
12450906,2024-12-01,Stade Rennais,Saint-Étienne,6,1,7
12450909,2024-12-01,Stade Brestois,RC Strasbourg,4,3,7
12450911,2024-12-01,Paris Saint-Germain,Nantes,9,3,12
12450910,2024-12-01,Montpellier,Lille,7,2,9
12450907,2024-12-01,Le Havre,Angers,2,4,6
12450913,2024-12-01,Olympique Lyonnais,Nice,5,4,9
12450908,2024-12-01,Toulouse,Auxerre,6,2,8
12450912,2024-12-01,Olympique de Marseille,AS Monaco,5,3,8
12436501,2024-11-30,Brighton & Hove Albion,Southampton,7,6,13
12436500,2024-11-30,Brentford,Leicester City,5,4,9
12436502,2024-11-30,Crystal Palace,Newcastle United,8,9,17
12436503,2024-11-30,Nottingham Forest,Ipswich Town,8,7,15
12436922,2024-11-30,Wolverhampton,Bournemouth,3,4,7
12436914,2024-11-30,West Ham United,Arsenal,2,10,12
12504678,2024-11-30,Cagliari,Hellas Verona,7,1,8
12504681,2024-11-30,Como,Monza,11,4,15
12504672,2024-11-30,Milan,Empoli,7,3,10
12504677,2024-11-30,Bologna,Venezia,1,0,1
12504665,2024-11-30,Udinese,Genoa,6,4,10
12437710,2024-11-30,Mallorca,Valencia,3,6,9
12437708,2024-11-30,Barcelona,Las Palmas,7,0,7
12437712,2024-11-30,Deportivo Alavés,Leganés,13,8,21
12437715,2024-11-30,Espanyol,Celta Vigo,2,5,7
12437720,2024-11-30,Real Valladolid,Atlético Madrid,3,5,8
12499468,2024-11-30,FC St. Pauli,Holstein Kiel,4,4,8
12499457,2024-11-30,1. FC Union Berlin,Bayer 04 Leverkusen,1,3,4
12499436,2024-11-30,FC Augsburg,VfL Bochum 1848,6,1,7
12499836,2024-11-30,RB Leipzig,VfL Wolfsburg,7,3,10
12499424,2024-11-30,SC Freiburg,Borussia M'gladbach,4,6,10
12499411,2024-11-30,SV Werder Bremen,VfB Stuttgart,11,2,13
12499387,2024-11-30,Borussia Dortmund,FC Bayern München,2,3,5
12450905,2024-11-30,Stade de Reims,RC Lens,3,1,4
12450906,2024-11-30,Stade Rennais,Saint-Étienne,6,1,7
12450909,2024-11-30,Stade Brestois,RC Strasbourg,4,3,7
12450911,2024-11-30,Paris Saint-Germain,Nantes,9,3,12
12436501,2024-11-29,Brighton & Hove Albion,Southampton,7,6,13
12504678,2024-11-29,Cagliari,Hellas Verona,7,1,8
12437710,2024-11-29,Mallorca,Valencia,3,6,9
12499468,2024-11-29,FC St. Pauli,Holstein Kiel,4,4,8
12450905,2024-11-29,Stade de Reims,RC Lens,3,1,4
12436496,2024-11-26,Newcastle United,West Ham United,8,3,11
12504685,2024-11-26,Empoli,Udinese,1,8,9
12504675,2024-11-26,Venezia,Lecce,6,2,8
12436506,2024-11-25,Southampton,Liverpool,3,10,13
12436497,2024-11-25,Ipswich Town,Manchester United,4,3,7
12436496,2024-11-25,Newcastle United,West Ham United,8,3,11
12504689,2024-11-25,Genoa,Cagliari,6,8,14
12504686,2024-11-25,Como,Fiorentina,3,4,7
12504682,2024-11-25,Torino,Monza,7,3,10
12504680,2024-11-25,Napoli,Roma,8,2,10
12504687,2024-11-25,Lazio,Bologna,3,0,3
12504685,2024-11-25,Empoli,Udinese,1,8,9
12504675,2024-11-25,Venezia,Lecce,6,2,8
12437688,2024-11-25,Osasuna,Villarreal,0,8,8
12437700,2024-11-25,Sevilla,Rayo Vallecano,8,3,11
12437693,2024-11-25,Leganés,Real Madrid,2,4,6
12437685,2024-11-25,Athletic Club,Real Sociedad,4,4,8
12499833,2024-11-25,Holstein Kiel,1. FSV Mainz 05,2,6,8
12499829,2024-11-25,Borussia M'gladbach,FC St. Pauli,5,4,9
12450896,2024-11-25,Lille,Stade Rennais,3,3,6
12450903,2024-11-25,Auxerre,Angers,2,2,4
12450901,2024-11-25,Nantes,Le Havre,10,2,12
12450889,2024-11-25,Nice,RC Strasbourg,4,7,11
12436495,2024-11-24,Leicester City,Chelsea,2,9,11
12436489,2024-11-24,Arsenal,Nottingham Forest,8,1,9
12436493,2024-11-24,Aston Villa,Crystal Palace,10,1,11
12436491,2024-11-24,Bournemouth,Brighton & Hove Albion,7,0,7
12436488,2024-11-24,Everton,Brentford,10,4,14
12436490,2024-11-24,Fulham,Wolverhampton,7,2,9
12436499,2024-11-24,Manchester City,Tottenham Hotspur,9,3,12
12436506,2024-11-24,Southampton,Liverpool,3,10,13
12436497,2024-11-24,Ipswich Town,Manchester United,4,3,7
12504684,2024-11-24,Hellas Verona,Inter,4,2,6
12504679,2024-11-24,Milan,Juventus,2,4,6
12504683,2024-11-24,Parma,Atalanta,2,5,7
12504689,2024-11-24,Genoa,Cagliari,6,8,14
12504686,2024-11-24,Como,Fiorentina,3,4,7
12504682,2024-11-24,Torino,Monza,7,3,10
12504680,2024-11-24,Napoli,Roma,8,2,10
12504687,2024-11-24,Lazio,Bologna,3,0,3
12437698,2024-11-24,Valencia,Real Betis,2,4,6
12437703,2024-11-24,Atlético Madrid,Deportivo Alavés,5,0,5
12437705,2024-11-24,Girona FC,Espanyol,6,3,9
12437691,2024-11-24,Las Palmas,Mallorca,4,3,7
12437696,2024-11-24,Celta Vigo,Barcelona,5,1,6
12437688,2024-11-24,Osasuna,Villarreal,0,8,8
12437700,2024-11-24,Sevilla,Rayo Vallecano,8,3,11
12437693,2024-11-24,Leganés,Real Madrid,2,4,6
12437685,2024-11-24,Athletic Club,Real Sociedad,4,4,8
12499806,2024-11-24,Bayer 04 Leverkusen,1. FC Heidenheim,6,0,6
12499816,2024-11-24,Borussia Dortmund,SC Freiburg,7,0,7
12499822,2024-11-24,TSG Hoffenheim,RB Leipzig,4,3,7
12499808,2024-11-24,VfB Stuttgart,VfL Bochum 1848,7,4,11
12499826,2024-11-24,VfL Wolfsburg,1. FC Union Berlin,8,5,13
12499819,2024-11-24,Eintracht Frankfurt,SV Werder Bremen,5,6,11
12499833,2024-11-24,Holstein Kiel,1. FSV Mainz 05,2,6,8
12499829,2024-11-24,Borussia M'gladbach,FC St. Pauli,5,4,9
12450885,2024-11-24,RC Lens,Olympique de Marseille,6,0,6
12450893,2024-11-24,Saint-Étienne,Montpellier,5,11,16
12450904,2024-11-24,Stade de Reims,Olympique Lyonnais,4,2,6
12450896,2024-11-24,Lille,Stade Rennais,3,3,6
12450903,2024-11-24,Auxerre,Angers,2,2,4
12450901,2024-11-24,Nantes,Le Havre,10,2,12
12450889,2024-11-24,Nice,RC Strasbourg,4,7,11
12436495,2024-11-23,Leicester City,Chelsea,2,9,11
12436489,2024-11-23,Arsenal,Nottingham Forest,8,1,9
12436493,2024-11-23,Aston Villa,Crystal Palace,10,1,11
12436491,2024-11-23,Bournemouth,Brighton & Hove Albion,7,0,7
12436488,2024-11-23,Everton,Brentford,10,4,14
12436490,2024-11-23,Fulham,Wolverhampton,7,2,9
12436499,2024-11-23,Manchester City,Tottenham Hotspur,9,3,12
12504684,2024-11-23,Hellas Verona,Inter,4,2,6
12504679,2024-11-23,Milan,Juventus,2,4,6
12504683,2024-11-23,Parma,Atalanta,2,5,7
12504689,2024-11-23,Genoa,Cagliari,6,8,14
12437686,2024-11-23,Getafe,Real Valladolid,3,2,5
12437698,2024-11-23,Valencia,Real Betis,2,4,6
12437703,2024-11-23,Atlético Madrid,Deportivo Alavés,5,0,5
12437705,2024-11-23,Girona FC,Espanyol,6,3,9
12437691,2024-11-23,Las Palmas,Mallorca,4,3,7
12437696,2024-11-23,Celta Vigo,Barcelona,5,1,6
12499812,2024-11-23,FC Bayern München,FC Augsburg,8,0,8
12499806,2024-11-23,Bayer 04 Leverkusen,1. FC Heidenheim,6,0,6
12499816,2024-11-23,Borussia Dortmund,SC Freiburg,7,0,7
12499822,2024-11-23,TSG Hoffenheim,RB Leipzig,4,3,7
12499808,2024-11-23,VfB Stuttgart,VfL Bochum 1848,7,4,11
12499826,2024-11-23,VfL Wolfsburg,1. FC Union Berlin,8,5,13
12499819,2024-11-23,Eintracht Frankfurt,SV Werder Bremen,5,6,11
12450902,2024-11-23,AS Monaco,Stade Brestois,2,8,10
12451080,2024-11-23,Paris Saint-Germain,Toulouse,7,5,12
12450885,2024-11-23,RC Lens,Olympique de Marseille,6,0,6
12450893,2024-11-23,Saint-Étienne,Montpellier,5,11,16
12450904,2024-11-23,Stade de Reims,Olympique Lyonnais,4,2,6
12437686,2024-11-22,Getafe,Real Valladolid,3,2,5
12499812,2024-11-22,FC Bayern München,FC Augsburg,8,0,8
12450902,2024-11-22,AS Monaco,Stade Brestois,2,8,10
12451080,2024-11-22,Paris Saint-Germain,Toulouse,7,5,12
12436494,2024-11-11,Manchester United,Leicester City,1,5,6
12436487,2024-11-11,Nottingham Forest,Newcastle United,4,5,9
12436492,2024-11-11,Tottenham Hotspur,Ipswich Town,12,2,14
12436890,2024-11-11,Chelsea,Arsenal,4,3,7
12504697,2024-11-11,Atalanta,Udinese,4,5,9
12504696,2024-11-11,Fiorentina,Hellas Verona,8,3,11
12504690,2024-11-11,Roma,Bologna,4,3,7
12504691,2024-11-11,Monza,Lazio,6,6,12
12504695,2024-11-11,Inter,Napoli,4,2,6
12437660,2024-11-11,Real Betis,Celta Vigo,2,0,2
12437673,2024-11-11,Mallorca,Atlético Madrid,7,2,9
12437662,2024-11-11,Getafe,Girona FC,5,2,7
12437670,2024-11-11,Real Valladolid,Athletic Club,5,5,10
12437675,2024-11-11,Real Sociedad,Barcelona,7,6,13
12499788,2024-11-11,FC Augsburg,TSG Hoffenheim,10,6,16
12499773,2024-11-11,VfB Stuttgart,Eintracht Frankfurt,8,3,11
12499781,2024-11-11,1. FC Heidenheim,VfL Wolfsburg,5,5,10
12451078,2024-11-11,Nice,Lille,6,2,8
12451074,2024-11-11,Le Havre,Stade de Reims,8,7,15
12451073,2024-11-11,Montpellier,Stade Brestois,3,7,10
12451077,2024-11-11,Stade Rennais,Toulouse,5,3,8
12451072,2024-11-11,Olympique Lyonnais,Saint-Étienne,7,6,13
12436876,2024-11-10,Brentford,Bournemouth,6,4,10
12436483,2024-11-10,Crystal Palace,Fulham,1,8,9
12436486,2024-11-10,West Ham United,Everton,7,6,13
12436485,2024-11-10,Wolverhampton,Southampton,1,9,10
12436882,2024-11-10,Brighton & Hove Albion,Manchester City,0,4,4
12436484,2024-11-10,Liverpool,Aston Villa,2,9,11
12436494,2024-11-10,Manchester United,Leicester City,1,5,6
12436487,2024-11-10,Nottingham Forest,Newcastle United,4,5,9
12436492,2024-11-10,Tottenham Hotspur,Ipswich Town,12,2,14
12436890,2024-11-10,Chelsea,Arsenal,4,3,7
12504688,2024-11-10,Venezia,Parma,6,6,12
12504701,2024-11-10,Cagliari,Milan,6,3,9
12504692,2024-11-10,Juventus,Torino,5,5,10
12504697,2024-11-10,Atalanta,Udinese,4,5,9
12504696,2024-11-10,Fiorentina,Hellas Verona,8,3,11
12504690,2024-11-10,Roma,Bologna,4,3,7
12504691,2024-11-10,Monza,Lazio,6,6,12
12504695,2024-11-10,Inter,Napoli,4,2,6
12437678,2024-11-10,Real Madrid,Osasuna,11,3,14
12437682,2024-11-10,Villarreal,Deportivo Alavés,7,2,9
12437666,2024-11-10,Leganés,Sevilla,0,6,6
12437660,2024-11-10,Real Betis,Celta Vigo,2,0,2
12437673,2024-11-10,Mallorca,Atlético Madrid,7,2,9
12437662,2024-11-10,Getafe,Girona FC,5,2,7
12437670,2024-11-10,Real Valladolid,Athletic Club,5,5,10
12437675,2024-11-10,Real Sociedad,Barcelona,7,6,13
12499791,2024-11-10,1. FSV Mainz 05,Borussia Dortmund,8,0,8
12499802,2024-11-10,FC St. Pauli,FC Bayern München,5,10,15
12499783,2024-11-10,SV Werder Bremen,Holstein Kiel,6,3,9
12499797,2024-11-10,VfL Bochum 1848,Bayer 04 Leverkusen,6,4,10
12499777,2024-11-10,RB Leipzig,Borussia M'gladbach,8,4,12
12499788,2024-11-10,FC Augsburg,TSG Hoffenheim,10,6,16
12499773,2024-11-10,VfB Stuttgart,Eintracht Frankfurt,8,3,11
12499781,2024-11-10,1. FC Heidenheim,VfL Wolfsburg,5,5,10
12451075,2024-11-10,RC Strasbourg,AS Monaco,1,2,3
12451076,2024-11-10,RC Lens,Nantes,6,1,7
12451079,2024-11-10,Angers,Paris Saint-Germain,6,8,14
12451078,2024-11-10,Nice,Lille,6,2,8
12451074,2024-11-10,Le Havre,Stade de Reims,8,7,15
12451073,2024-11-10,Montpellier,Stade Brestois,3,7,10
12451077,2024-11-10,Stade Rennais,Toulouse,5,3,8
12451072,2024-11-10,Olympique Lyonnais,Saint-Étienne,7,6,13
12436876,2024-11-09,Brentford,Bournemouth,6,4,10
12436483,2024-11-09,Crystal Palace,Fulham,1,8,9
12436486,2024-11-09,West Ham United,Everton,7,6,13
12436485,2024-11-09,Wolverhampton,Southampton,1,9,10
12436882,2024-11-09,Brighton & Hove Albion,Manchester City,0,4,4
12436484,2024-11-09,Liverpool,Aston Villa,2,9,11
12504694,2024-11-09,Lecce,Empoli,4,3,7
12504688,2024-11-09,Venezia,Parma,6,6,12
12504701,2024-11-09,Cagliari,Milan,6,3,9
12504692,2024-11-09,Juventus,Torino,5,5,10
12504697,2024-11-09,Atalanta,Udinese,4,5,9
12437680,2024-11-09,Rayo Vallecano,Las Palmas,12,4,16
12437678,2024-11-09,Real Madrid,Osasuna,11,3,14
12437682,2024-11-09,Villarreal,Deportivo Alavés,7,2,9
12437666,2024-11-09,Leganés,Sevilla,0,6,6
12499794,2024-11-09,1. FC Union Berlin,SC Freiburg,4,1,5
12499791,2024-11-09,1. FSV Mainz 05,Borussia Dortmund,8,0,8
12499802,2024-11-09,FC St. Pauli,FC Bayern München,5,10,15
12499783,2024-11-09,SV Werder Bremen,Holstein Kiel,6,3,9
12499797,2024-11-09,VfL Bochum 1848,Bayer 04 Leverkusen,6,4,10
12499777,2024-11-09,RB Leipzig,Borussia M'gladbach,8,4,12
12451071,2024-11-09,Olympique de Marseille,Auxerre,5,3,8
12451075,2024-11-09,RC Strasbourg,AS Monaco,1,2,3
12451076,2024-11-09,RC Lens,Nantes,6,1,7
12451079,2024-11-09,Angers,Paris Saint-Germain,6,8,14
12504693,2024-11-08,Genoa,Como,8,5,13
12504694,2024-11-08,Lecce,Empoli,4,3,7
12437680,2024-11-08,Rayo Vallecano,Las Palmas,12,4,16
12499794,2024-11-08,1. FC Union Berlin,SC Freiburg,4,1,5
12451071,2024-11-08,Olympique de Marseille,Auxerre,5,3,8
12504693,2024-11-07,Genoa,Como,8,5,13
12437052,2024-11-05,Fulham,Brentford,11,3,14
12499360,2024-11-05,Empoli,Como,3,6,9
12504699,2024-11-05,Parma,Genoa,3,7,10
12504698,2024-11-05,Lazio,Cagliari,2,3,5
12437639,2024-11-05,Celta Vigo,Getafe,0,2,2
12437059,2024-11-04,Tottenham Hotspur,Aston Villa,6,4,10
12437055,2024-11-04,Manchester United,Chelsea,4,8,12
12437052,2024-11-04,Fulham,Brentford,11,3,14
12504704,2024-11-04,Napoli,Atalanta,4,3,7
12504700,2024-11-04,Torino,Fiorentina,1,3,4
12504706,2024-11-04,Hellas Verona,Roma,2,2,4
12504702,2024-11-04,Inter,Venezia,9,3,12
12499360,2024-11-04,Empoli,Como,3,6,9
12504699,2024-11-04,Parma,Genoa,3,7,10
12504698,2024-11-04,Lazio,Cagliari,2,3,5
12437637,2024-11-04,Atlético Madrid,Las Palmas,9,1,10
12437658,2024-11-04,Barcelona,Espanyol,9,5,14
12437655,2024-11-04,Sevilla,Real Sociedad,5,9,14
12437634,2024-11-04,Athletic Club,Real Betis,6,2,8
12437639,2024-11-04,Celta Vigo,Getafe,0,2,2
12499760,2024-11-04,SC Freiburg,1. FSV Mainz 05,8,4,12
12499767,2024-11-04,Borussia M'gladbach,SV Werder Bremen,7,7,14
12451061,2024-11-04,Toulouse,Stade de Reims,6,7,13
12451060,2024-11-04,Auxerre,Stade Rennais,3,8,11
12451063,2024-11-04,Le Havre,Montpellier,2,10,12
12451065,2024-11-04,Nantes,Olympique de Marseille,2,5,7
12437056,2024-11-03,Newcastle United,Arsenal,4,6,10
12437051,2024-11-03,Bournemouth,Manchester City,3,10,13
12437053,2024-11-03,Ipswich Town,Leicester City,4,6,10
12437054,2024-11-03,Liverpool,Brighton & Hove Albion,9,7,16
12437057,2024-11-03,Nottingham Forest,West Ham United,10,6,16
12437058,2024-11-03,Southampton,Everton,3,6,9
12437060,2024-11-03,Wolverhampton,Crystal Palace,3,6,9
12437059,2024-11-03,Tottenham Hotspur,Aston Villa,6,4,10
12437055,2024-11-03,Manchester United,Chelsea,4,8,12
12499359,2024-11-03,Bologna,Lecce,9,1,10
12504703,2024-11-03,Udinese,Juventus,10,3,13
12504705,2024-11-03,Monza,Milan,3,5,8
12504704,2024-11-03,Napoli,Atalanta,4,3,7
12504700,2024-11-03,Torino,Fiorentina,1,3,4
12504706,2024-11-03,Hellas Verona,Roma,2,2,4
12504702,2024-11-03,Inter,Venezia,9,3,12
12437644,2024-11-03,Osasuna,Real Valladolid,7,2,9
12437641,2024-11-03,Girona FC,Leganés,6,1,7
12437637,2024-11-03,Atlético Madrid,Las Palmas,9,1,10
12437658,2024-11-03,Barcelona,Espanyol,9,5,14
12437655,2024-11-03,Sevilla,Real Sociedad,5,9,14
12437634,2024-11-03,Athletic Club,Real Betis,6,2,8
12499753,2024-11-03,Eintracht Frankfurt,VfL Bochum 1848,5,2,7
12499746,2024-11-03,FC Bayern München,1. FC Union Berlin,7,4,11
12499771,2024-11-03,Holstein Kiel,1. FC Heidenheim,5,6,11
12499757,2024-11-03,TSG Hoffenheim,FC St. Pauli,7,2,9
12499763,2024-11-03,VfL Wolfsburg,FC Augsburg,8,1,9
12499750,2024-11-03,Borussia Dortmund,RB Leipzig,4,0,4
12499760,2024-11-03,SC Freiburg,1. FSV Mainz 05,8,4,12
12499767,2024-11-03,Borussia M'gladbach,SV Werder Bremen,7,7,14
12451069,2024-11-03,Paris Saint-Germain,RC Lens,7,4,11
12451068,2024-11-03,Stade Brestois,Nice,6,2,8
12451067,2024-11-03,Saint-Étienne,RC Strasbourg,2,3,5
12451061,2024-11-03,Toulouse,Stade de Reims,6,7,13
12451060,2024-11-03,Auxerre,Stade Rennais,3,8,11
12451063,2024-11-03,Le Havre,Montpellier,2,10,12
12451065,2024-11-03,Nantes,Olympique de Marseille,2,5,7
12437056,2024-11-02,Newcastle United,Arsenal,4,6,10
12437051,2024-11-02,Bournemouth,Manchester City,3,10,13
12437053,2024-11-02,Ipswich Town,Leicester City,4,6,10
12437054,2024-11-02,Liverpool,Brighton & Hove Albion,9,7,16
12437057,2024-11-02,Nottingham Forest,West Ham United,10,6,16
12437058,2024-11-02,Southampton,Everton,3,6,9
12437060,2024-11-02,Wolverhampton,Crystal Palace,3,6,9
12499359,2024-11-02,Bologna,Lecce,9,1,10
12504703,2024-11-02,Udinese,Juventus,10,3,13
12504705,2024-11-02,Monza,Milan,3,5,8
12504704,2024-11-02,Napoli,Atalanta,4,3,7
12437646,2024-11-02,Deportivo Alavés,Mallorca,7,2,9
12437644,2024-11-02,Osasuna,Real Valladolid,7,2,9
12437641,2024-11-02,Girona FC,Leganés,6,1,7
12499743,2024-11-02,Bayer 04 Leverkusen,VfB Stuttgart,10,2,12
12499753,2024-11-02,Eintracht Frankfurt,VfL Bochum 1848,5,2,7
12499746,2024-11-02,FC Bayern München,1. FC Union Berlin,7,4,11
12499771,2024-11-02,Holstein Kiel,1. FC Heidenheim,5,6,11
12499757,2024-11-02,TSG Hoffenheim,FC St. Pauli,7,2,9
12499763,2024-11-02,VfL Wolfsburg,FC Augsburg,8,1,9
12499750,2024-11-02,Borussia Dortmund,RB Leipzig,4,0,4
12451062,2024-11-02,AS Monaco,Angers,4,4,8
12451066,2024-11-02,Lille,Olympique Lyonnais,4,9,13
12451069,2024-11-02,Paris Saint-Germain,RC Lens,7,4,11
12451068,2024-11-02,Stade Brestois,Nice,6,2,8
12451067,2024-11-02,Saint-Étienne,RC Strasbourg,2,3,5
12499351,2024-11-01,Genoa,Fiorentina,4,4,8
12499349,2024-11-01,Como,Lazio,3,5,8
12499356,2024-11-01,Roma,Torino,3,5,8
12437646,2024-11-01,Deportivo Alavés,Mallorca,7,2,9
12499743,2024-11-01,Bayer 04 Leverkusen,VfB Stuttgart,10,2,12
12451062,2024-11-01,AS Monaco,Angers,4,4,8
12451066,2024-11-01,Lille,Olympique Lyonnais,4,9,13
12499350,2024-10-31,Empoli,Inter,1,4,5
12499357,2024-10-31,Venezia,Udinese,2,6,8
12499347,2024-10-31,Atalanta,Monza,5,1,6
12499353,2024-10-31,Juventus,Parma,10,6,16
12499351,2024-10-31,Genoa,Fiorentina,4,4,8
12499349,2024-10-31,Como,Lazio,3,5,8
12499356,2024-10-31,Roma,Torino,3,5,8
12499348,2024-10-30,Cagliari,Bologna,7,2,9
12499354,2024-10-30,Lecce,Hellas Verona,3,4,7
12499355,2024-10-30,Milan,Napoli,5,1,6
12499350,2024-10-30,Empoli,Inter,1,4,5
12499357,2024-10-30,Venezia,Udinese,2,6,8
12499347,2024-10-30,Atalanta,Monza,5,1,6
12499353,2024-10-30,Juventus,Parma,10,6,16
12499348,2024-10-29,Cagliari,Bologna,7,2,9
12499354,2024-10-29,Lecce,Hellas Verona,3,4,7
12499355,2024-10-29,Milan,Napoli,5,1,6
12437611,2024-10-29,Mallorca,Athletic Club,1,14,15
12437045,2024-10-28,Chelsea,Newcastle United,7,4,11
12437046,2024-10-28,Crystal Palace,Tottenham Hotspur,8,8,16
12437050,2024-10-28,West Ham United,Manchester United,6,5,11
12437040,2024-10-28,Arsenal,Liverpool,1,3,4
12499344,2024-10-28,Parma,Empoli,9,3,12
12499340,2024-10-28,Lazio,Genoa,7,4,11
12499341,2024-10-28,Monza,Venezia,4,3,7
12499339,2024-10-28,Inter,Juventus,13,5,18
12499338,2024-10-28,Fiorentina,Roma,6,2,8
12437618,2024-10-28,Leganés,Celta Vigo,4,2,6
12437607,2024-10-28,Getafe,Valencia,8,2,10
12437613,2024-10-28,Real Betis,Atlético Madrid,3,10,13
12437625,2024-10-28,Real Sociedad,Osasuna,14,4,18
12437611,2024-10-28,Mallorca,Athletic Club,1,14,15
12499737,2024-10-28,VfL Bochum 1848,FC Bayern München,2,6,8
12499734,2024-10-28,1. FC Union Berlin,Eintracht Frankfurt,4,5,9
12499720,2024-10-28,1. FC Heidenheim,TSG Hoffenheim,7,3,10
12451054,2024-10-28,Olympique Lyonnais,Auxerre,5,5,10
12451055,2024-10-28,Montpellier,Toulouse,1,3,4
12451051,2024-10-28,Nice,AS Monaco,6,6,12
12451056,2024-10-28,RC Strasbourg,Nantes,5,4,9
12451053,2024-10-28,Olympique de Marseille,Paris Saint-Germain,1,2,3
12437041,2024-10-27,Aston Villa,Bournemouth,9,7,16
12437043,2024-10-27,Brentford,Ipswich Town,4,5,9
12437044,2024-10-27,Brighton & Hove Albion,Wolverhampton,9,6,15
12437049,2024-10-27,Manchester City,Southampton,12,1,13
12437047,2024-10-27,Everton,Fulham,4,2,6
12437045,2024-10-27,Chelsea,Newcastle United,7,4,11
12437046,2024-10-27,Crystal Palace,Tottenham Hotspur,8,8,16
12437050,2024-10-27,West Ham United,Manchester United,6,5,11
12437040,2024-10-27,Arsenal,Liverpool,1,3,4
12499342,2024-10-27,Napoli,Lecce,16,5,21
12499336,2024-10-27,Atalanta,Hellas Verona,4,2,6
12499344,2024-10-27,Parma,Empoli,9,3,12
12499340,2024-10-27,Lazio,Genoa,7,4,11
12499341,2024-10-27,Monza,Venezia,4,3,7
12499339,2024-10-27,Inter,Juventus,13,5,18
12499338,2024-10-27,Fiorentina,Roma,6,2,8
12437627,2024-10-27,Real Valladolid,Villarreal,4,6,10
12437630,2024-10-27,Rayo Vallecano,Deportivo Alavés,6,2,8
12437620,2024-10-27,Las Palmas,Girona FC,3,5,8
12437616,2024-10-27,Real Madrid,Barcelona,10,3,13
12437618,2024-10-27,Leganés,Celta Vigo,4,2,6
12437607,2024-10-27,Getafe,Valencia,8,2,10
12437613,2024-10-27,Real Betis,Atlético Madrid,3,10,13
12437625,2024-10-27,Real Sociedad,Osasuna,14,4,18
12499727,2024-10-27,FC Augsburg,Borussia Dortmund,3,5,8
12499740,2024-10-27,FC St. Pauli,VfL Wolfsburg,7,6,13
12499717,2024-10-27,RB Leipzig,SC Freiburg,3,3,6
12499713,2024-10-27,VfB Stuttgart,Holstein Kiel,9,5,14
12499723,2024-10-27,SV Werder Bremen,Bayer 04 Leverkusen,3,5,8
12499737,2024-10-27,VfL Bochum 1848,FC Bayern München,2,6,8
12499734,2024-10-27,1. FC Union Berlin,Eintracht Frankfurt,4,5,9
12499720,2024-10-27,1. FC Heidenheim,TSG Hoffenheim,7,3,10
12451058,2024-10-27,Angers,Saint-Étienne,2,3,5
12451059,2024-10-27,Stade de Reims,Stade Brestois,7,3,10
12451052,2024-10-27,RC Lens,Lille,8,2,10
12451054,2024-10-27,Olympique Lyonnais,Auxerre,5,5,10
12451055,2024-10-27,Montpellier,Toulouse,1,3,4
12451051,2024-10-27,Nice,AS Monaco,6,6,12
12451056,2024-10-27,RC Strasbourg,Nantes,5,4,9
12451053,2024-10-27,Olympique de Marseille,Paris Saint-Germain,1,2,3
12437048,2024-10-26,Leicester City,Nottingham Forest,6,7,13
12437041,2024-10-26,Aston Villa,Bournemouth,9,7,16
12437043,2024-10-26,Brentford,Ipswich Town,4,5,9
12437044,2024-10-26,Brighton & Hove Albion,Wolverhampton,9,6,15
12437049,2024-10-26,Manchester City,Southampton,12,1,13
12437047,2024-10-26,Everton,Fulham,4,2,6
12499346,2024-10-26,Udinese,Cagliari,2,4,6
12499345,2024-10-26,Torino,Como,1,3,4
12499342,2024-10-26,Napoli,Lecce,16,5,21
12499336,2024-10-26,Atalanta,Hellas Verona,4,2,6
12499344,2024-10-26,Parma,Empoli,9,3,12
12437609,2024-10-26,Espanyol,Sevilla,13,2,15
12437627,2024-10-26,Real Valladolid,Villarreal,4,6,10
12437630,2024-10-26,Rayo Vallecano,Deportivo Alavés,6,2,8
12437620,2024-10-26,Las Palmas,Girona FC,3,5,8
12437616,2024-10-26,Real Madrid,Barcelona,10,3,13
12499730,2024-10-26,1. FSV Mainz 05,Borussia M'gladbach,2,4,6
12499727,2024-10-26,FC Augsburg,Borussia Dortmund,3,5,8
12499740,2024-10-26,FC St. Pauli,VfL Wolfsburg,7,6,13
12499717,2024-10-26,RB Leipzig,SC Freiburg,3,3,6
12499713,2024-10-26,VfB Stuttgart,Holstein Kiel,9,5,14
12499723,2024-10-26,SV Werder Bremen,Bayer 04 Leverkusen,3,5,8
12451057,2024-10-26,Stade Rennais,Le Havre,14,0,14
12451058,2024-10-26,Angers,Saint-Étienne,2,3,5
12451059,2024-10-26,Stade de Reims,Stade Brestois,7,3,10
12451052,2024-10-26,RC Lens,Lille,8,2,10
12437048,2024-10-25,Leicester City,Nottingham Forest,6,7,13
12499346,2024-10-25,Udinese,Cagliari,2,4,6
12499345,2024-10-25,Torino,Como,1,3,4
12437609,2024-10-25,Espanyol,Sevilla,13,2,15
12499730,2024-10-25,1. FSV Mainz 05,Borussia M'gladbach,2,4,6
12451057,2024-10-25,Stade Rennais,Le Havre,14,0,14
12437036,2024-10-22,Nottingham Forest,Crystal Palace,6,6,12
12499329,2024-10-22,Hellas Verona,Monza,9,6,15
12437854,2024-10-22,Valencia,Las Palmas,11,2,13
12437039,2024-10-21,Wolverhampton,Manchester City,1,18,19
12437032,2024-10-21,Liverpool,Chelsea,1,5,6
12437036,2024-10-21,Nottingham Forest,Crystal Palace,6,6,12
12499327,2024-10-21,Empoli,Napoli,7,7,14
12499331,2024-10-21,Lecce,Fiorentina,1,3,4
12499335,2024-10-21,Venezia,Atalanta,2,5,7
12499325,2024-10-21,Cagliari,Torino,9,12,21
12499334,2024-10-21,Roma,Inter,3,3,6
12499329,2024-10-21,Hellas Verona,Monza,9,6,15
12437847,2024-10-21,Mallorca,Rayo Vallecano,9,2,11
12437835,2024-10-21,Atlético Madrid,Leganés,8,2,10
12437852,2024-10-21,Villarreal,Getafe,5,5,10
12437839,2024-10-21,Barcelona,Sevilla,5,5,10
12437854,2024-10-21,Valencia,Las Palmas,11,2,13
12499710,2024-10-21,Holstein Kiel,1. FC Union Berlin,7,3,10
12499700,2024-10-21,VfL Wolfsburg,SV Werder Bremen,4,4,8
12451038,2024-10-21,Le Havre,Olympique Lyonnais,4,6,10
12451034,2024-10-21,Auxerre,Stade de Reims,5,9,14
12451040,2024-10-21,Nantes,Nice,4,8,12
12451036,2024-10-21,Toulouse,Angers,8,2,10
12451042,2024-10-21,Montpellier,Olympique de Marseille,3,2,5
12437038,2024-10-20,Tottenham Hotspur,West Ham United,13,5,18
12437028,2024-10-20,Fulham,Aston Villa,6,11,17
12437034,2024-10-20,Manchester United,Brentford,9,2,11
12437035,2024-10-20,Newcastle United,Brighton & Hove Albion,9,4,13
12437037,2024-10-20,Southampton,Leicester City,10,6,16
12437030,2024-10-20,Ipswich Town,Everton,5,7,12
12437026,2024-10-20,Bournemouth,Arsenal,7,4,11
12437039,2024-10-20,Wolverhampton,Manchester City,1,18,19
12437032,2024-10-20,Liverpool,Chelsea,1,5,6
12499326,2024-10-20,Como,Parma,7,4,11
12499328,2024-10-20,Genoa,Bologna,1,7,8
12499333,2024-10-20,Milan,Udinese,8,4,12
12499330,2024-10-20,Juventus,Lazio,7,1,8
12499327,2024-10-20,Empoli,Napoli,7,7,14
12499331,2024-10-20,Lecce,Fiorentina,1,3,4
12499335,2024-10-20,Venezia,Atalanta,2,5,7
12499325,2024-10-20,Cagliari,Torino,9,12,21
12499334,2024-10-20,Roma,Inter,3,3,6
12437855,2024-10-20,Athletic Club,Espanyol,5,5,10
12437851,2024-10-20,Osasuna,Real Betis,10,2,12
12437843,2024-10-20,Girona FC,Real Sociedad,6,6,12
12437842,2024-10-20,Celta Vigo,Real Madrid,6,2,8
12437847,2024-10-20,Mallorca,Rayo Vallecano,9,2,11
12437835,2024-10-20,Atlético Madrid,Leganés,8,2,10
12437852,2024-10-20,Villarreal,Getafe,5,5,10
12437839,2024-10-20,Barcelona,Sevilla,5,5,10
12499703,2024-10-20,1. FSV Mainz 05,RB Leipzig,5,3,8
12499681,2024-10-20,Bayer 04 Leverkusen,Eintracht Frankfurt,8,3,11
12499707,2024-10-20,Borussia M'gladbach,1. FC Heidenheim,6,3,9
12499694,2024-10-20,SC Freiburg,FC Augsburg,5,4,9
12499690,2024-10-20,TSG Hoffenheim,VfL Bochum 1848,4,2,6
12499684,2024-10-20,FC Bayern München,VfB Stuttgart,7,3,10
12499710,2024-10-20,Holstein Kiel,1. FC Union Berlin,7,3,10
12499700,2024-10-20,VfL Wolfsburg,SV Werder Bremen,4,4,8
12451048,2024-10-20,Stade Brestois,Stade Rennais,2,4,6
12451046,2024-10-20,Saint-Étienne,RC Lens,2,7,9
12451049,2024-10-20,Paris Saint-Germain,RC Strasbourg,5,5,10
12451038,2024-10-20,Le Havre,Olympique Lyonnais,4,6,10
12451034,2024-10-20,Auxerre,Stade de Reims,5,9,14
12451040,2024-10-20,Nantes,Nice,4,8,12
12451036,2024-10-20,Toulouse,Angers,8,2,10
12451042,2024-10-20,Montpellier,Olympique de Marseille,3,2,5
12437038,2024-10-19,Tottenham Hotspur,West Ham United,13,5,18
12437028,2024-10-19,Fulham,Aston Villa,6,11,17
12437034,2024-10-19,Manchester United,Brentford,9,2,11
12437035,2024-10-19,Newcastle United,Brighton & Hove Albion,9,4,13
12437037,2024-10-19,Southampton,Leicester City,10,6,16
12437030,2024-10-19,Ipswich Town,Everton,5,7,12
12437026,2024-10-19,Bournemouth,Arsenal,7,4,11
12499326,2024-10-19,Como,Parma,7,4,11
12499328,2024-10-19,Genoa,Bologna,1,7,8
12499333,2024-10-19,Milan,Udinese,8,4,12
12499330,2024-10-19,Juventus,Lazio,7,1,8
12499327,2024-10-19,Empoli,Napoli,7,7,14
12437849,2024-10-19,Deportivo Alavés,Real Valladolid,5,6,11
12437855,2024-10-19,Athletic Club,Espanyol,5,5,10
12437851,2024-10-19,Osasuna,Real Betis,10,2,12
12437843,2024-10-19,Girona FC,Real Sociedad,6,6,12
12437842,2024-10-19,Celta Vigo,Real Madrid,6,2,8
12499687,2024-10-19,Borussia Dortmund,FC St. Pauli,7,1,8
12499703,2024-10-19,1. FSV Mainz 05,RB Leipzig,5,3,8
12499681,2024-10-19,Bayer 04 Leverkusen,Eintracht Frankfurt,8,3,11
12499707,2024-10-19,Borussia M'gladbach,1. FC Heidenheim,6,3,9
12499694,2024-10-19,SC Freiburg,FC Augsburg,5,4,9
12499690,2024-10-19,TSG Hoffenheim,VfL Bochum 1848,4,2,6
12499684,2024-10-19,FC Bayern München,VfB Stuttgart,7,3,10
12451044,2024-10-19,AS Monaco,Lille,6,1,7
12451048,2024-10-19,Stade Brestois,Stade Rennais,2,4,6
12451046,2024-10-19,Saint-Étienne,RC Lens,2,7,9
12451049,2024-10-19,Paris Saint-Germain,RC Strasbourg,5,5,10
12437038,2024-10-18,Tottenham Hotspur,West Ham United,13,5,18
12437849,2024-10-18,Deportivo Alavés,Real Valladolid,5,6,11
12499687,2024-10-18,Borussia Dortmund,FC St. Pauli,7,1,8
12451044,2024-10-18,AS Monaco,Lille,6,1,7
12437006,2024-10-07,Aston Villa,Manchester United,6,3,9
12437013,2024-10-07,Chelsea,Nottingham Forest,11,3,14
12437011,2024-10-07,Brighton & Hove Albion,Tottenham Hotspur,4,7,11
12499320,2024-10-07,Juventus,Cagliari,8,3,11
12499316,2024-10-07,Bologna,Parma,13,6,19
12499321,2024-10-07,Lazio,Empoli,5,3,8
12499322,2024-10-07,Monza,Roma,1,3,4
12499317,2024-10-07,Fiorentina,Milan,0,7,7
12437824,2024-10-07,Girona FC,Athletic Club,6,1,7
12437815,2024-10-07,Deportivo Alavés,Barcelona,11,3,14
12437828,2024-10-07,Sevilla,Real Betis,4,1,5
12437826,2024-10-07,Real Sociedad,Atlético Madrid,5,1,6
12499660,2024-10-07,1. FC Heidenheim,RB Leipzig,3,2,5
12499656,2024-10-07,Eintracht Frankfurt,FC Bayern München,0,11,11
12499654,2024-10-07,VfB Stuttgart,TSG Hoffenheim,10,5,15
12451017,2024-10-07,Olympique Lyonnais,Nantes,6,9,15
12451031,2024-10-07,RC Strasbourg,RC Lens,3,5,8
12451025,2024-10-07,Stade Brestois,Le Havre,1,9,10
12451033,2024-10-07,Stade de Reims,Montpellier,4,4,8
12451019,2024-10-07,Nice,Paris Saint-Germain,5,15,20
12437015,2024-10-06,Crystal Palace,Liverpool,3,8,11
12437004,2024-10-06,Arsenal,Southampton,13,1,14
12437008,2024-10-06,Brentford,Wolverhampton,10,3,13
12437020,2024-10-06,Leicester City,Bournemouth,0,9,9
12437022,2024-10-06,Manchester City,Fulham,8,3,11
12437024,2024-10-06,West Ham United,Ipswich Town,5,5,10
12437018,2024-10-06,Everton,Newcastle United,0,10,10
12437006,2024-10-06,Aston Villa,Manchester United,6,3,9
12437013,2024-10-06,Chelsea,Nottingham Forest,11,3,14
12437011,2024-10-06,Brighton & Hove Albion,Tottenham Hotspur,4,7,11
12499324,2024-10-06,Udinese,Lecce,5,0,5
12499315,2024-10-06,Atalanta,Genoa,4,2,6
12499319,2024-10-06,Inter,Torino,14,0,14
12499320,2024-10-06,Juventus,Cagliari,8,3,11
12499316,2024-10-06,Bologna,Parma,13,6,19
12499321,2024-10-06,Lazio,Empoli,5,3,8
12499322,2024-10-06,Monza,Roma,1,3,4
12499317,2024-10-06,Fiorentina,Milan,0,7,7
12437820,2024-10-06,Espanyol,Mallorca,4,6,10
12437810,2024-10-06,Getafe,Osasuna,4,2,6
12437832,2024-10-06,Las Palmas,Celta Vigo,11,2,13
12437833,2024-10-06,Real Valladolid,Rayo Vallecano,5,13,18
12437813,2024-10-06,Real Madrid,Villarreal,2,5,7
12437824,2024-10-06,Girona FC,Athletic Club,6,1,7
12437815,2024-10-06,Deportivo Alavés,Barcelona,11,3,14
12437828,2024-10-06,Sevilla,Real Betis,4,1,5
12437826,2024-10-06,Real Sociedad,Atlético Madrid,5,1,6
12499671,2024-10-06,1. FC Union Berlin,Borussia Dortmund,3,3,6
12499652,2024-10-06,Bayer 04 Leverkusen,Holstein Kiel,12,3,15
12499664,2024-10-06,SV Werder Bremen,SC Freiburg,7,5,12
12499674,2024-10-06,VfL Bochum 1848,VfL Wolfsburg,7,6,13
12499677,2024-10-06,FC St. Pauli,1. FSV Mainz 05,2,2,4
12499660,2024-10-06,1. FC Heidenheim,RB Leipzig,3,2,5
12499656,2024-10-06,Eintracht Frankfurt,FC Bayern München,0,11,11
12499654,2024-10-06,VfB Stuttgart,TSG Hoffenheim,10,5,15
12451023,2024-10-06,Saint-Étienne,Auxerre,5,4,9
12451021,2024-10-06,Lille,Toulouse,4,6,10
12451029,2024-10-06,Stade Rennais,AS Monaco,10,4,14
12451017,2024-10-06,Olympique Lyonnais,Nantes,6,9,15
12451031,2024-10-06,RC Strasbourg,RC Lens,3,5,8
12451025,2024-10-06,Stade Brestois,Le Havre,1,9,10
12451033,2024-10-06,Stade de Reims,Montpellier,4,4,8
12451019,2024-10-06,Nice,Paris Saint-Germain,5,15,20
12437015,2024-10-05,Crystal Palace,Liverpool,3,8,11
12437004,2024-10-05,Arsenal,Southampton,13,1,14
12437008,2024-10-05,Brentford,Wolverhampton,10,3,13
12437020,2024-10-05,Leicester City,Bournemouth,0,9,9
12437022,2024-10-05,Manchester City,Fulham,8,3,11
12437024,2024-10-05,West Ham United,Ipswich Town,5,5,10
12437018,2024-10-05,Everton,Newcastle United,0,10,10
12499323,2024-10-05,Napoli,Como,4,1,5
12499318,2024-10-05,Hellas Verona,Venezia,13,6,19
12499324,2024-10-05,Udinese,Lecce,5,0,5
12499315,2024-10-05,Atalanta,Genoa,4,2,6
12499319,2024-10-05,Inter,Torino,14,0,14
12499320,2024-10-05,Juventus,Cagliari,8,3,11
12437818,2024-10-05,Leganés,Valencia,1,2,3
12437820,2024-10-05,Espanyol,Mallorca,4,6,10
12437810,2024-10-05,Getafe,Osasuna,4,2,6
12437832,2024-10-05,Las Palmas,Celta Vigo,11,2,13
12437833,2024-10-05,Real Valladolid,Rayo Vallecano,5,13,18
12437813,2024-10-05,Real Madrid,Villarreal,2,5,7
12499666,2024-10-05,FC Augsburg,Borussia M'gladbach,6,5,11
12499671,2024-10-05,1. FC Union Berlin,Borussia Dortmund,3,3,6
12499652,2024-10-05,Bayer 04 Leverkusen,Holstein Kiel,12,3,15
12499664,2024-10-05,SV Werder Bremen,SC Freiburg,7,5,12
12499674,2024-10-05,VfL Bochum 1848,VfL Wolfsburg,7,6,13
12499677,2024-10-05,FC St. Pauli,1. FSV Mainz 05,2,2,4
12451027,2024-10-05,Olympique de Marseille,Angers,9,3,12
12451023,2024-10-05,Saint-Étienne,Auxerre,5,4,9
12451021,2024-10-05,Lille,Toulouse,4,6,10
12451029,2024-10-05,Stade Rennais,AS Monaco,10,4,14
12437015,2024-10-04,Crystal Palace,Liverpool,3,8,11
12499323,2024-10-04,Napoli,Como,4,1,5
12499318,2024-10-04,Hellas Verona,Venezia,13,6,19
12437818,2024-10-04,Leganés,Valencia,1,2,3
12499666,2024-10-04,FC Augsburg,Borussia M'gladbach,6,5,11
12451027,2024-10-04,Olympique de Marseille,Angers,9,3,12
12436982,2024-10-01,Bournemouth,Southampton,6,4,10
12499311,2024-10-01,Parma,Cagliari,5,3,8
12437800,2024-10-01,Villarreal,Las Palmas,3,2,5
12436993,2024-09-30,Ipswich Town,Aston Villa,10,0,10
12436995,2024-09-30,Manchester United,Tottenham Hotspur,5,3,8
12436982,2024-09-30,Bournemouth,Southampton,6,4,10
12499313,2024-09-30,Torino,Lazio,3,1,4
12499306,2024-09-30,Como,Hellas Verona,9,1,10
12499312,2024-09-30,Roma,Venezia,6,3,9
12499307,2024-09-30,Empoli,Fiorentina,2,4,6
12499310,2024-09-30,Napoli,Monza,1,3,4
12499311,2024-09-30,Parma,Cagliari,5,3,8
12437789,2024-09-30,Celta Vigo,Girona FC,4,4,8
12437784,2024-09-30,Athletic Club,Sevilla,4,7,11
12437808,2024-09-30,Real Betis,Espanyol,8,4,12
12437787,2024-09-30,Atlético Madrid,Real Madrid,5,5,10
12437800,2024-09-30,Villarreal,Las Palmas,3,2,5
12499648,2024-09-30,Holstein Kiel,Eintracht Frankfurt,4,9,13
12499631,2024-09-30,TSG Hoffenheim,SV Werder Bremen,2,6,8
12451012,2024-09-30,Toulouse,Olympique Lyonnais,3,4,7
12451016,2024-09-30,Angers,Stade de Reims,5,4,9
12451008,2024-09-30,Nantes,Saint-Étienne,8,4,12
12451001,2024-09-30,RC Strasbourg,Olympique de Marseille,8,3,11
12436999,2024-09-29,Newcastle United,Manchester City,5,6,11
12436985,2024-09-29,Arsenal,Leicester City,17,0,17
12436987,2024-09-29,Brentford,West Ham United,7,6,13
12436989,2024-09-29,Chelsea,Brighton & Hove Albion,8,2,10
12436992,2024-09-29,Everton,Crystal Palace,5,8,13
12437001,2024-09-29,Nottingham Forest,Fulham,6,5,11
12437002,2024-09-29,Wolverhampton,Liverpool,2,10,12
12436993,2024-09-29,Ipswich Town,Aston Villa,10,0,10
12436995,2024-09-29,Manchester United,Tottenham Hotspur,5,3,8
12499314,2024-09-29,Udinese,Inter,7,3,10
12499308,2024-09-29,Genoa,Juventus,5,3,8
12499305,2024-09-29,Bologna,Atalanta,2,9,11
12499313,2024-09-29,Torino,Lazio,3,1,4
12499306,2024-09-29,Como,Hellas Verona,9,1,10
12499312,2024-09-29,Roma,Venezia,6,3,9
12499307,2024-09-29,Empoli,Fiorentina,2,4,6
12499310,2024-09-29,Napoli,Monza,1,3,4
12437803,2024-09-29,Getafe,Deportivo Alavés,2,2,4
12437805,2024-09-29,Rayo Vallecano,Leganés,5,5,10
12437792,2024-09-29,Real Sociedad,Valencia,6,4,10
12437795,2024-09-29,Osasuna,Barcelona,5,8,13
12437789,2024-09-29,Celta Vigo,Girona FC,4,4,8
12437784,2024-09-29,Athletic Club,Sevilla,4,7,11
12437808,2024-09-29,Real Betis,Espanyol,8,4,12
12437787,2024-09-29,Atlético Madrid,Real Madrid,5,5,10
12499642,2024-09-29,1. FSV Mainz 05,1. FC Heidenheim,7,6,13
12499644,2024-09-29,Borussia M'gladbach,1. FC Union Berlin,2,4,6
12499624,2024-09-29,RB Leipzig,FC Augsburg,8,5,13
12499633,2024-09-29,SC Freiburg,FC St. Pauli,4,2,6
12499638,2024-09-29,VfL Wolfsburg,VfB Stuttgart,1,3,4
12499620,2024-09-29,FC Bayern München,Bayer 04 Leverkusen,6,1,7
12499648,2024-09-29,Holstein Kiel,Eintracht Frankfurt,4,9,13
12499631,2024-09-29,TSG Hoffenheim,SV Werder Bremen,2,6,8
12451006,2024-09-29,RC Lens,Nice,11,4,15
12451010,2024-09-29,Le Havre,Lille,1,5,6
12451014,2024-09-29,AS Monaco,Montpellier,6,2,8
12451012,2024-09-29,Toulouse,Olympique Lyonnais,3,4,7
12451016,2024-09-29,Angers,Stade de Reims,5,4,9
12451008,2024-09-29,Nantes,Saint-Étienne,8,4,12
12451001,2024-09-29,RC Strasbourg,Olympique de Marseille,8,3,11
12436999,2024-09-28,Newcastle United,Manchester City,5,6,11
12436985,2024-09-28,Arsenal,Leicester City,17,0,17
12436987,2024-09-28,Brentford,West Ham United,7,6,13
12436989,2024-09-28,Chelsea,Brighton & Hove Albion,8,2,10
12436992,2024-09-28,Everton,Crystal Palace,5,8,13
12437001,2024-09-28,Nottingham Forest,Fulham,6,5,11
12437002,2024-09-28,Wolverhampton,Liverpool,2,10,12
12499309,2024-09-28,Milan,Lecce,4,7,11
12499314,2024-09-28,Udinese,Inter,7,3,10
12499308,2024-09-28,Genoa,Juventus,5,3,8
12499305,2024-09-28,Bologna,Atalanta,2,9,11
12499313,2024-09-28,Torino,Lazio,3,1,4
12437798,2024-09-28,Real Valladolid,Mallorca,7,4,11
12437803,2024-09-28,Getafe,Deportivo Alavés,2,2,4
12437805,2024-09-28,Rayo Vallecano,Leganés,5,5,10
12437792,2024-09-28,Real Sociedad,Valencia,6,4,10
12437795,2024-09-28,Osasuna,Barcelona,5,8,13
12499627,2024-09-28,Borussia Dortmund,VfL Bochum 1848,11,0,11
12499642,2024-09-28,1. FSV Mainz 05,1. FC Heidenheim,7,6,13
12499644,2024-09-28,Borussia M'gladbach,1. FC Union Berlin,2,4,6
12499624,2024-09-28,RB Leipzig,FC Augsburg,8,5,13
12499633,2024-09-28,SC Freiburg,FC St. Pauli,4,2,6
12499638,2024-09-28,VfL Wolfsburg,VfB Stuttgart,1,3,4
12499620,2024-09-28,FC Bayern München,Bayer 04 Leverkusen,6,1,7
12451004,2024-09-28,Auxerre,Stade Brestois,2,3,5
12451002,2024-09-28,Paris Saint-Germain,Stade Rennais,6,4,10
12451006,2024-09-28,RC Lens,Nice,11,4,15
12451010,2024-09-28,Le Havre,Lille,1,5,6
12451014,2024-09-28,AS Monaco,Montpellier,6,2,8
12436999,2024-09-27,Newcastle United,Manchester City,5,6,11
12499309,2024-09-27,Milan,Lecce,4,7,11
12437768,2024-09-27,Espanyol,Villarreal,4,1,5
12437777,2024-09-27,Las Palmas,Real Betis,1,4,5
12437774,2024-09-27,Celta Vigo,Atlético Madrid,2,3,5
12437798,2024-09-27,Real Valladolid,Mallorca,7,4,11
12499627,2024-09-27,Borussia Dortmund,VfL Bochum 1848,11,0,11
12451004,2024-09-27,Auxerre,Stade Brestois,2,3,5
12451002,2024-09-27,Paris Saint-Germain,Stade Rennais,6,4,10
12437761,2024-09-26,Girona FC,Rayo Vallecano,4,3,7
12437758,2024-09-26,Barcelona,Getafe,7,5,12
12437768,2024-09-26,Espanyol,Villarreal,4,1,5
12437777,2024-09-26,Las Palmas,Real Betis,1,4,5
12437774,2024-09-26,Celta Vigo,Atlético Madrid,2,3,5
12499295,2024-09-25,Atalanta,Como,6,2,8
12437766,2024-09-25,Sevilla,Real Valladolid,6,4,10
12437779,2024-09-25,Valencia,Osasuna,10,5,15
12437782,2024-09-25,Real Madrid,Deportivo Alavés,4,4,8
12437761,2024-09-25,Girona FC,Rayo Vallecano,4,3,7
12437758,2024-09-25,Barcelona,Getafe,7,5,12
12499295,2024-09-24,Atalanta,Como,6,2,8
12437736,2024-09-24,Real Betis,Mallorca,6,3,9
12437766,2024-09-24,Sevilla,Real Valladolid,6,4,10
12437779,2024-09-24,Valencia,Osasuna,10,5,15
12437782,2024-09-24,Real Madrid,Deportivo Alavés,4,4,8
12436959,2024-09-23,Brighton & Hove Albion,Nottingham Forest,9,1,10
12436971,2024-09-23,Manchester City,Arsenal,8,2,10
12499297,2024-09-23,Fiorentina,Lazio,3,10,13
12499302,2024-09-23,Monza,Bologna,2,2,4
12499303,2024-09-23,Roma,Udinese,2,1,3
12499299,2024-09-23,Inter,Milan,6,2,8
12437739,2024-09-23,Getafe,Leganés,6,2,8
12437734,2024-09-23,Athletic Club,Celta Vigo,3,6,9
12437746,2024-09-23,Villarreal,Barcelona,7,3,10
12437744,2024-09-23,Rayo Vallecano,Atlético Madrid,3,4,7
12437736,2024-09-23,Real Betis,Mallorca,6,3,9
12499591,2024-09-23,Bayer 04 Leverkusen,VfL Wolfsburg,6,2,8
12499595,2024-09-23,VfB Stuttgart,Borussia Dortmund,6,4,10
12499617,2024-09-23,FC St. Pauli,RB Leipzig,3,1,4
12450999,2024-09-23,AS Monaco,Le Havre,6,4,10
12450991,2024-09-23,Angers,Nantes,3,6,9
12450993,2024-09-23,Montpellier,Auxerre,11,5,16
12450989,2024-09-23,Stade Brestois,Toulouse,4,3,7
12450984,2024-09-23,Olympique Lyonnais,Olympique de Marseille,10,3,13
12436980,2024-09-22,West Ham United,Chelsea,6,5,11
12436957,2024-09-22,Aston Villa,Wolverhampton,6,5,11
12436964,2024-09-22,Fulham,Newcastle United,6,0,6
12436967,2024-09-22,Leicester City,Everton,6,1,7
12436969,2024-09-22,Liverpool,Bournemouth,3,9,12
12436973,2024-09-22,Southampton,Ipswich Town,2,10,12
12436977,2024-09-22,Tottenham Hotspur,Brentford,9,4,13
12436962,2024-09-22,Crystal Palace,Manchester United,4,11,15
12436959,2024-09-22,Brighton & Hove Albion,Nottingham Forest,9,1,10
12436971,2024-09-22,Manchester City,Arsenal,8,2,10
12499304,2024-09-22,Venezia,Genoa,3,4,7
12499300,2024-09-22,Juventus,Napoli,4,3,7
12499301,2024-09-22,Lecce,Parma,2,12,14
12499297,2024-09-22,Fiorentina,Lazio,3,10,13
12499302,2024-09-22,Monza,Bologna,2,2,4
12499303,2024-09-22,Roma,Udinese,2,1,3
12499299,2024-09-22,Inter,Milan,6,2,8
12437751,2024-09-22,Real Valladolid,Real Sociedad,5,7,12
12437753,2024-09-22,Osasuna,Las Palmas,2,4,6
12437748,2024-09-22,Valencia,Girona FC,5,4,9
12437756,2024-09-22,Real Madrid,Espanyol,9,4,13
12437739,2024-09-22,Getafe,Leganés,6,2,8
12437734,2024-09-22,Athletic Club,Celta Vigo,3,6,9
12437746,2024-09-22,Villarreal,Barcelona,7,3,10
12437744,2024-09-22,Rayo Vallecano,Atlético Madrid,3,4,7
12499600,2024-09-22,1. FC Heidenheim,SC Freiburg,3,9,12
12499610,2024-09-22,1. FC Union Berlin,TSG Hoffenheim,5,5,10
12499604,2024-09-22,SV Werder Bremen,FC Bayern München,1,4,5
12499614,2024-09-22,VfL Bochum 1848,Holstein Kiel,2,5,7
12499598,2024-09-22,Eintracht Frankfurt,Borussia M'gladbach,8,5,13
12499591,2024-09-22,Bayer 04 Leverkusen,VfL Wolfsburg,6,2,8
12499595,2024-09-22,VfB Stuttgart,Borussia Dortmund,6,4,10
12499617,2024-09-22,FC St. Pauli,RB Leipzig,3,1,4
12450995,2024-09-22,Lille,RC Strasbourg,9,5,14
12450997,2024-09-22,Stade Rennais,RC Lens,4,3,7
12450988,2024-09-22,Stade de Reims,Paris Saint-Germain,3,5,8
12450999,2024-09-22,AS Monaco,Le Havre,6,4,10
12450991,2024-09-22,Angers,Nantes,3,6,9
12450993,2024-09-22,Montpellier,Auxerre,11,5,16
12450989,2024-09-22,Stade Brestois,Toulouse,4,3,7
12450984,2024-09-22,Olympique Lyonnais,Olympique de Marseille,10,3,13
12436980,2024-09-21,West Ham United,Chelsea,6,5,11
12436957,2024-09-21,Aston Villa,Wolverhampton,6,5,11
12436964,2024-09-21,Fulham,Newcastle United,6,0,6
12436967,2024-09-21,Leicester City,Everton,6,1,7
12436969,2024-09-21,Liverpool,Bournemouth,3,9,12
12436973,2024-09-21,Southampton,Ipswich Town,2,10,12
12436977,2024-09-21,Tottenham Hotspur,Brentford,9,4,13
12436962,2024-09-21,Crystal Palace,Manchester United,4,11,15
12499296,2024-09-21,Cagliari,Empoli,10,4,14
12499298,2024-09-21,Hellas Verona,Torino,5,6,11
12499304,2024-09-21,Venezia,Genoa,3,4,7
12499300,2024-09-21,Juventus,Napoli,4,3,7
12499301,2024-09-21,Lecce,Parma,2,12,14
12499297,2024-09-21,Fiorentina,Lazio,3,10,13
12437741,2024-09-21,Deportivo Alavés,Sevilla,3,5,8
12437751,2024-09-21,Real Valladolid,Real Sociedad,5,7,12
12437753,2024-09-21,Osasuna,Las Palmas,2,4,6
12437748,2024-09-21,Valencia,Girona FC,5,4,9
12437756,2024-09-21,Real Madrid,Espanyol,9,4,13
12499607,2024-09-21,FC Augsburg,1. FSV Mainz 05,14,1,15
12499600,2024-09-21,1. FC Heidenheim,SC Freiburg,3,9,12
12499610,2024-09-21,1. FC Union Berlin,TSG Hoffenheim,5,5,10
12499604,2024-09-21,SV Werder Bremen,FC Bayern München,1,4,5
12499614,2024-09-21,VfL Bochum 1848,Holstein Kiel,2,5,7
12499598,2024-09-21,Eintracht Frankfurt,Borussia M'gladbach,8,5,13
12450986,2024-09-21,Nice,Saint-Étienne,3,2,5
12450995,2024-09-21,Lille,RC Strasbourg,9,5,14
12450997,2024-09-21,Stade Rennais,RC Lens,4,3,7
12450988,2024-09-21,Stade de Reims,Paris Saint-Germain,3,5,8
12436980,2024-09-20,West Ham United,Chelsea,6,5,11
12499296,2024-09-20,Cagliari,Empoli,10,4,14
12499298,2024-09-20,Hellas Verona,Torino,5,6,11
12437772,2024-09-20,Leganés,Athletic Club,4,7,11
12437741,2024-09-20,Deportivo Alavés,Sevilla,3,5,8
12499607,2024-09-20,FC Augsburg,1. FSV Mainz 05,14,1,15
12450986,2024-09-20,Nice,Saint-Étienne,3,2,5
12778688,2024-09-19,Real Betis,Getafe,8,4,12
12437772,2024-09-19,Leganés,Athletic Club,4,7,11
12437763,2024-09-18,Mallorca,Real Sociedad,5,5,10
12778688,2024-09-18,Real Betis,Getafe,8,4,12
12499293,2024-09-17,Parma,Udinese,5,6,11
12499290,2024-09-17,Lazio,Hellas Verona,9,6,15
12437726,2024-09-17,Rayo Vallecano,Osasuna,7,4,11
12437763,2024-09-17,Mallorca,Real Sociedad,5,5,10
12436951,2024-09-16,Tottenham Hotspur,Arsenal,7,6,13
12436954,2024-09-16,Wolverhampton,Newcastle United,4,7,11
12499289,2024-09-16,Genoa,Roma,4,5,9
12499285,2024-09-16,Atalanta,Fiorentina,5,2,7
12499294,2024-09-16,Torino,Lecce,2,7,9
12499286,2024-09-16,Cagliari,Napoli,7,4,11
12499292,2024-09-16,Monza,Inter,1,8,9
12499293,2024-09-16,Parma,Udinese,5,6,11
12499290,2024-09-16,Lazio,Hellas Verona,9,6,15
12437714,2024-09-16,Celta Vigo,Real Valladolid,5,3,8
12437721,2024-09-16,Girona FC,Barcelona,1,6,7
12437718,2024-09-16,Las Palmas,Athletic Club,9,3,12
12437709,2024-09-16,Atlético Madrid,Valencia,7,3,10
12437726,2024-09-16,Rayo Vallecano,Osasuna,7,4,11
12499575,2024-09-16,FC Augsburg,FC St. Pauli,7,7,14
12499581,2024-09-16,1. FSV Mainz 05,SV Werder Bremen,10,4,14
12450969,2024-09-16,Stade Rennais,Montpellier,3,4,7
12450973,2024-09-16,Nantes,Stade de Reims,6,3,9
12450977,2024-09-16,RC Strasbourg,Angers,6,9,15
12450975,2024-09-16,Toulouse,Le Havre,6,5,11
12450971,2024-09-16,RC Lens,Olympique Lyonnais,5,8,13
12436949,2024-09-15,Southampton,Manchester United,0,7,7
12436936,2024-09-15,Brighton & Hove Albion,Ipswich Town,9,2,11
12436938,2024-09-15,Crystal Palace,Leicester City,5,2,7
12436941,2024-09-15,Fulham,West Ham United,3,2,5
12436944,2024-09-15,Liverpool,Nottingham Forest,7,2,9
12436946,2024-09-15,Manchester City,Brentford,12,3,15
12436933,2024-09-15,Aston Villa,Everton,6,2,8
12436931,2024-09-15,Bournemouth,Chelsea,6,3,9
12436951,2024-09-15,Tottenham Hotspur,Arsenal,7,6,13
12436954,2024-09-15,Wolverhampton,Newcastle United,4,7,11
12499287,2024-09-15,Como,Bologna,4,3,7
12499288,2024-09-15,Empoli,Juventus,4,8,12
12499291,2024-09-15,Milan,Venezia,6,1,7
12499289,2024-09-15,Genoa,Roma,4,5,9
12499285,2024-09-15,Atalanta,Fiorentina,5,2,7
12499294,2024-09-15,Torino,Lecce,2,7,9
12499286,2024-09-15,Cagliari,Napoli,7,4,11
12499292,2024-09-15,Monza,Inter,1,8,9
12437716,2024-09-15,Mallorca,Villarreal,7,6,13
12437730,2024-09-15,Espanyol,Deportivo Alavés,0,5,5
12437723,2024-09-15,Sevilla,Getafe,3,4,7
12437728,2024-09-15,Real Sociedad,Real Madrid,6,6,12
12437714,2024-09-15,Celta Vigo,Real Valladolid,5,3,8
12437721,2024-09-15,Girona FC,Barcelona,1,6,7
12437718,2024-09-15,Las Palmas,Athletic Club,9,3,12
12437709,2024-09-15,Atlético Madrid,Valencia,7,3,10
12499585,2024-09-15,Borussia M'gladbach,VfB Stuttgart,6,2,8
12499546,2024-09-15,RB Leipzig,1. FC Union Berlin,6,5,11
12499571,2024-09-15,SC Freiburg,VfL Bochum 1848,5,6,11
12499552,2024-09-15,TSG Hoffenheim,Bayer 04 Leverkusen,4,12,16
12499577,2024-09-15,VfL Wolfsburg,Eintracht Frankfurt,5,4,9
12499588,2024-09-15,Holstein Kiel,FC Bayern München,2,10,12
12499575,2024-09-15,FC Augsburg,FC St. Pauli,7,7,14
12499581,2024-09-15,1. FSV Mainz 05,SV Werder Bremen,10,4,14
12450980,2024-09-15,Olympique de Marseille,Nice,1,2,3
12450967,2024-09-15,Auxerre,AS Monaco,1,6,7
12450982,2024-09-15,Paris Saint-Germain,Stade Brestois,9,1,10
12450969,2024-09-15,Stade Rennais,Montpellier,3,4,7
12450973,2024-09-15,Nantes,Stade de Reims,6,3,9
12450977,2024-09-15,RC Strasbourg,Angers,6,9,15
12450975,2024-09-15,Toulouse,Le Havre,6,5,11
12450971,2024-09-15,RC Lens,Olympique Lyonnais,5,8,13
12436949,2024-09-14,Southampton,Manchester United,0,7,7
12436936,2024-09-14,Brighton & Hove Albion,Ipswich Town,9,2,11
12436938,2024-09-14,Crystal Palace,Leicester City,5,2,7
12436941,2024-09-14,Fulham,West Ham United,3,2,5
12436944,2024-09-14,Liverpool,Nottingham Forest,7,2,9
12436946,2024-09-14,Manchester City,Brentford,12,3,15
12436933,2024-09-14,Aston Villa,Everton,6,2,8
12436931,2024-09-14,Bournemouth,Chelsea,6,3,9
12499287,2024-09-14,Como,Bologna,4,3,7
12499288,2024-09-14,Empoli,Juventus,4,8,12
12499291,2024-09-14,Milan,Venezia,6,1,7
12499289,2024-09-14,Genoa,Roma,4,5,9
12437711,2024-09-14,Real Betis,Leganés,11,1,12
12437716,2024-09-14,Mallorca,Villarreal,7,6,13
12437730,2024-09-14,Espanyol,Deportivo Alavés,0,5,5
12437723,2024-09-14,Sevilla,Getafe,3,4,7
12437728,2024-09-14,Real Sociedad,Real Madrid,6,6,12
12499549,2024-09-14,Borussia Dortmund,1. FC Heidenheim,8,1,9
12499585,2024-09-14,Borussia M'gladbach,VfB Stuttgart,6,2,8
12499546,2024-09-14,RB Leipzig,1. FC Union Berlin,6,5,11
12499571,2024-09-14,SC Freiburg,VfL Bochum 1848,5,6,11
12499552,2024-09-14,TSG Hoffenheim,Bayer 04 Leverkusen,4,12,16
12499577,2024-09-14,VfL Wolfsburg,Eintracht Frankfurt,5,4,9
12499588,2024-09-14,Holstein Kiel,FC Bayern München,2,10,12
12450978,2024-09-14,Saint-Étienne,Lille,2,7,9
12450980,2024-09-14,Olympique de Marseille,Nice,1,2,3
12450967,2024-09-14,Auxerre,AS Monaco,1,6,7
12450982,2024-09-14,Paris Saint-Germain,Stade Brestois,9,1,10
12436949,2024-09-13,Southampton,Manchester United,0,7,7
12437711,2024-09-13,Real Betis,Leganés,11,1,12
12499549,2024-09-13,Borussia Dortmund,1. FC Heidenheim,8,1,9
12450978,2024-09-13,Saint-Étienne,Lille,2,7,9
12436910,2024-09-02,Chelsea,Crystal Palace,4,4,8
12436923,2024-09-02,Newcastle United,Tottenham Hotspur,7,12,19
12436920,2024-09-02,Manchester United,Liverpool,5,2,7
12499276,2024-09-02,Fiorentina,Monza,7,0,7
12499277,2024-09-02,Genoa,Hellas Verona,3,1,4
12499279,2024-09-02,Juventus,Roma,6,4,10
12499283,2024-09-02,Udinese,Como,4,6,10
12437694,2024-09-02,Deportivo Alavés,Las Palmas,6,5,11
12437704,2024-09-02,Osasuna,Celta Vigo,6,3,9
12437706,2024-09-02,Sevilla,Girona FC,7,5,12
12437690,2024-09-02,Getafe,Real Sociedad,4,1,5
12437702,2024-09-02,Real Madrid,Real Betis,7,3,10
12499507,2024-09-02,1. FC Heidenheim,FC Augsburg,5,6,11
12499488,2024-09-02,FC Bayern München,SC Freiburg,2,4,6
12450960,2024-09-02,AS Monaco,RC Lens,7,7,14
12450958,2024-09-02,Angers,Nice,4,7,11
12450962,2024-09-02,Le Havre,Auxerre,2,2,4
12450964,2024-09-02,Stade de Reims,Stade Rennais,3,5,8
12450883,2024-09-02,Lille,Paris Saint-Germain,3,1,4
12436906,2024-09-01,Arsenal,Brighton & Hove Albion,3,7,10
12436908,2024-09-01,Brentford,Southampton,2,8,10
12436912,2024-09-01,Everton,Bournemouth,8,4,12
12436915,2024-09-01,Ipswich Town,Fulham,8,6,14
12436918,2024-09-01,Leicester City,Aston Villa,1,4,5
12436926,2024-09-01,Nottingham Forest,Wolverhampton,7,3,10
12436927,2024-09-01,West Ham United,Manchester City,3,11,14
12436910,2024-09-01,Chelsea,Crystal Palace,4,4,8
12436923,2024-09-01,Newcastle United,Tottenham Hotspur,7,12,19
12436920,2024-09-01,Manchester United,Liverpool,5,2,7
12499275,2024-09-01,Bologna,Empoli,6,3,9
12499281,2024-09-01,Lecce,Cagliari,7,10,17
12499280,2024-09-01,Lazio,Milan,5,7,12
12499282,2024-09-01,Napoli,Parma,6,4,10
12499276,2024-09-01,Fiorentina,Monza,7,0,7
12499277,2024-09-01,Genoa,Hellas Verona,3,1,4
12499279,2024-09-01,Juventus,Roma,6,4,10
12499283,2024-09-01,Udinese,Como,4,6,10
12437687,2024-09-01,Barcelona,Real Valladolid,10,1,11
12437684,2024-09-01,Athletic Club,Atlético Madrid,2,2,4
12437699,2024-09-01,Espanyol,Rayo Vallecano,3,7,10
12437697,2024-09-01,Leganés,Mallorca,1,3,4
12437692,2024-09-01,Valencia,Villarreal,14,3,17
12437694,2024-09-01,Deportivo Alavés,Las Palmas,6,5,11
12437704,2024-09-01,Osasuna,Celta Vigo,6,3,9
12437706,2024-09-01,Sevilla,Girona FC,7,5,12
12437690,2024-09-01,Getafe,Real Sociedad,4,1,5
12437702,2024-09-01,Real Madrid,Real Betis,7,3,10
12499498,2024-09-01,Eintracht Frankfurt,TSG Hoffenheim,1,4,5
12499540,2024-09-01,Holstein Kiel,VfL Wolfsburg,1,7,8
12499514,2024-09-01,SV Werder Bremen,Borussia Dortmund,5,6,11
12499480,2024-09-01,VfB Stuttgart,1. FSV Mainz 05,11,2,13
12499533,2024-09-01,VfL Bochum 1848,Borussia M'gladbach,3,4,7
12499471,2024-09-01,Bayer 04 Leverkusen,RB Leipzig,18,2,20
12499507,2024-09-01,1. FC Heidenheim,FC Augsburg,5,6,11
12499488,2024-09-01,FC Bayern München,SC Freiburg,2,4,6
12450955,2024-09-01,Stade Brestois,Saint-Étienne,7,2,9
12450956,2024-09-01,Montpellier,Nantes,8,3,11
12450966,2024-09-01,Toulouse,Olympique de Marseille,2,3,5
12450960,2024-09-01,AS Monaco,RC Lens,7,7,14
12450958,2024-09-01,Angers,Nice,4,7,11
12450962,2024-09-01,Le Havre,Auxerre,2,2,4
12450964,2024-09-01,Stade de Reims,Stade Rennais,3,5,8
12450883,2024-09-01,Lille,Paris Saint-Germain,3,1,4
12436906,2024-08-31,Arsenal,Brighton & Hove Albion,3,7,10
12436908,2024-08-31,Brentford,Southampton,2,8,10
12436912,2024-08-31,Everton,Bournemouth,8,4,12
12436915,2024-08-31,Ipswich Town,Fulham,8,6,14
12436918,2024-08-31,Leicester City,Aston Villa,1,4,5
12436926,2024-08-31,Nottingham Forest,Wolverhampton,7,3,10
12436927,2024-08-31,West Ham United,Manchester City,3,11,14
12499284,2024-08-31,Venezia,Torino,3,3,6
12499278,2024-08-31,Inter,Atalanta,3,4,7
12499275,2024-08-31,Bologna,Empoli,6,3,9
12499281,2024-08-31,Lecce,Cagliari,7,10,17
12499280,2024-08-31,Lazio,Milan,5,7,12
12499282,2024-08-31,Napoli,Parma,6,4,10
12437687,2024-08-31,Barcelona,Real Valladolid,10,1,11
12437684,2024-08-31,Athletic Club,Atlético Madrid,2,2,4
12437699,2024-08-31,Espanyol,Rayo Vallecano,3,7,10
12437697,2024-08-31,Leganés,Mallorca,1,3,4
12437692,2024-08-31,Valencia,Villarreal,14,3,17
12499524,2024-08-31,1. FC Union Berlin,FC St. Pauli,5,4,9
12499498,2024-08-31,Eintracht Frankfurt,TSG Hoffenheim,1,4,5
12499540,2024-08-31,Holstein Kiel,VfL Wolfsburg,1,7,8
12499514,2024-08-31,SV Werder Bremen,Borussia Dortmund,5,6,11
12499480,2024-08-31,VfB Stuttgart,1. FSV Mainz 05,11,2,13
12499533,2024-08-31,VfL Bochum 1848,Borussia M'gladbach,3,4,7
12499471,2024-08-31,Bayer 04 Leverkusen,RB Leipzig,18,2,20
12450884,2024-08-31,Olympique Lyonnais,RC Strasbourg,9,2,11
12450955,2024-08-31,Stade Brestois,Saint-Étienne,7,2,9
12450956,2024-08-31,Montpellier,Nantes,8,3,11
12450966,2024-08-31,Toulouse,Olympique de Marseille,2,3,5
12436906,2024-08-30,Arsenal,Brighton & Hove Albion,3,7,10
12499284,2024-08-30,Venezia,Torino,3,3,6
12499278,2024-08-30,Inter,Atalanta,3,4,7
12437664,2024-08-30,Girona FC,Osasuna,5,0,5
12437669,2024-08-30,Las Palmas,Real Madrid,2,6,8
12499524,2024-08-30,1. FC Union Berlin,FC St. Pauli,5,4,9
12450884,2024-08-30,Olympique Lyonnais,RC Strasbourg,9,2,11
12437659,2024-08-29,Athletic Club,Valencia,5,3,8
12437679,2024-08-29,Real Valladolid,Leganés,4,4,8
12437681,2024-08-29,Atlético Madrid,Espanyol,9,3,12
12437676,2024-08-29,Real Sociedad,Deportivo Alavés,8,6,14
12437664,2024-08-29,Girona FC,Osasuna,5,0,5
12437669,2024-08-29,Las Palmas,Real Madrid,2,6,8
12437667,2024-08-28,Mallorca,Sevilla,5,9,14
12437672,2024-08-28,Rayo Vallecano,Barcelona,6,6,12
12437659,2024-08-28,Athletic Club,Valencia,5,3,8
12437679,2024-08-28,Real Valladolid,Leganés,4,4,8
12437681,2024-08-28,Atlético Madrid,Espanyol,9,3,12
12437676,2024-08-28,Real Sociedad,Deportivo Alavés,8,6,14
12499265,2024-08-27,Cagliari,Como,5,6,11
12499267,2024-08-27,Hellas Verona,Juventus,4,1,5
12437674,2024-08-27,Villarreal,Celta Vigo,7,4,11
12437667,2024-08-27,Mallorca,Sevilla,5,9,14
12437672,2024-08-27,Rayo Vallecano,Barcelona,6,6,12
12436884,2024-08-26,Bournemouth,Newcastle United,8,9,17
12436904,2024-08-26,Wolverhampton,Chelsea,5,5,10
12436896,2024-08-26,Liverpool,Brentford,9,4,13
12499266,2024-08-26,Fiorentina,Venezia,7,3,10
12499273,2024-08-26,Torino,Atalanta,4,6,10
12499270,2024-08-26,Napoli,Bologna,7,5,12
12499272,2024-08-26,Roma,Empoli,8,5,13
12499265,2024-08-26,Cagliari,Como,5,6,11
12499267,2024-08-26,Hellas Verona,Juventus,4,1,5
12437638,2024-08-26,Real Madrid,Real Valladolid,5,5,10
12437647,2024-08-26,Leganés,Las Palmas,3,7,10
12437645,2024-08-26,Deportivo Alavés,Real Betis,3,8,11
12437628,2024-08-26,Atlético Madrid,Girona FC,1,9,10
12437674,2024-08-26,Villarreal,Celta Vigo,7,4,11
12583571,2024-08-26,VfL Wolfsburg,FC Bayern München,1,7,8
12499462,2024-08-26,FC St. Pauli,1. FC Heidenheim,4,2,6
12450880,2024-08-26,RC Lens,Stade Brestois,5,2,7
12450876,2024-08-26,Nantes,Auxerre,3,12,15
12450879,2024-08-26,Nice,Toulouse,4,4,8
12450875,2024-08-26,RC Strasbourg,Stade Rennais,2,5,7
12450882,2024-08-26,Olympique de Marseille,Stade de Reims,2,4,6
12436888,2024-08-25,Brighton & Hove Albion,Manchester United,4,4,8
12436892,2024-08-25,Crystal Palace,West Ham United,3,3,6
12436894,2024-08-25,Fulham,Leicester City,7,5,12
12436898,2024-08-25,Manchester City,Ipswich Town,10,1,11
12436900,2024-08-25,Southampton,Nottingham Forest,4,10,14
12436902,2024-08-25,Tottenham Hotspur,Everton,12,5,17
12436886,2024-08-25,Aston Villa,Arsenal,4,1,5
12436884,2024-08-25,Bournemouth,Newcastle United,8,9,17
12436904,2024-08-25,Wolverhampton,Chelsea,5,5,10
12436896,2024-08-25,Liverpool,Brentford,9,4,13
12499271,2024-08-25,Parma,Milan,3,9,12
12499274,2024-08-25,Udinese,Lazio,4,13,17
12499268,2024-08-25,Inter,Lecce,10,6,16
12499269,2024-08-25,Monza,Genoa,8,3,11
12499266,2024-08-25,Fiorentina,Venezia,7,3,10
12499273,2024-08-25,Torino,Atalanta,4,6,10
12499270,2024-08-25,Napoli,Bologna,7,5,12
12499272,2024-08-25,Roma,Empoli,8,5,13
12437656,2024-08-25,Osasuna,Mallorca,5,4,9
12437652,2024-08-25,Barcelona,Athletic Club,5,6,11
12437650,2024-08-25,Espanyol,Real Sociedad,7,4,11
12437636,2024-08-25,Getafe,Rayo Vallecano,3,2,5
12437638,2024-08-25,Real Madrid,Real Valladolid,5,5,10
12437647,2024-08-25,Leganés,Las Palmas,3,7,10
12437645,2024-08-25,Deportivo Alavés,Real Betis,3,8,11
12437628,2024-08-25,Atlético Madrid,Girona FC,1,9,10
12499452,2024-08-25,1. FSV Mainz 05,1. FC Union Berlin,8,9,17
12499430,2024-08-25,FC Augsburg,SV Werder Bremen,4,2,6
12499386,2024-08-25,RB Leipzig,VfL Bochum 1848,9,3,12
12499418,2024-08-25,SC Freiburg,VfB Stuttgart,6,3,9
12499406,2024-08-25,TSG Hoffenheim,Holstein Kiel,8,6,14
12499391,2024-08-25,Borussia Dortmund,Eintracht Frankfurt,7,7,14
12583571,2024-08-25,VfL Wolfsburg,FC Bayern München,1,7,8
12499462,2024-08-25,FC St. Pauli,1. FC Heidenheim,4,2,6
12450881,2024-08-25,Olympique Lyonnais,AS Monaco,0,6,6
12450878,2024-08-25,Lille,Angers,3,2,5
12450877,2024-08-25,Saint-Étienne,Le Havre,2,4,6
12450880,2024-08-25,RC Lens,Stade Brestois,5,2,7
12450876,2024-08-25,Nantes,Auxerre,3,12,15
12450879,2024-08-25,Nice,Toulouse,4,4,8
12450875,2024-08-25,RC Strasbourg,Stade Rennais,2,5,7
12450882,2024-08-25,Olympique de Marseille,Stade de Reims,2,4,6
12436888,2024-08-24,Brighton & Hove Albion,Manchester United,4,4,8
12436892,2024-08-24,Crystal Palace,West Ham United,3,3,6
12436894,2024-08-24,Fulham,Leicester City,7,5,12
12436898,2024-08-24,Manchester City,Ipswich Town,10,1,11
12436900,2024-08-24,Southampton,Nottingham Forest,4,10,14
12436902,2024-08-24,Tottenham Hotspur,Everton,12,5,17
12436886,2024-08-24,Aston Villa,Arsenal,4,1,5
12499271,2024-08-24,Parma,Milan,3,9,12
12499274,2024-08-24,Udinese,Lazio,4,13,17
12499268,2024-08-24,Inter,Lecce,10,6,16
12499269,2024-08-24,Monza,Genoa,8,3,11
12437631,2024-08-24,Celta Vigo,Valencia,4,7,11
12437642,2024-08-24,Sevilla,Villarreal,7,2,9
12437656,2024-08-24,Osasuna,Mallorca,5,4,9
12437652,2024-08-24,Barcelona,Athletic Club,5,6,11
12437650,2024-08-24,Espanyol,Real Sociedad,7,4,11
12437636,2024-08-24,Getafe,Rayo Vallecano,3,2,5
12499375,2024-08-24,Borussia M'gladbach,Bayer 04 Leverkusen,2,4,6
12499452,2024-08-24,1. FSV Mainz 05,1. FC Union Berlin,8,9,17
12499430,2024-08-24,FC Augsburg,SV Werder Bremen,4,2,6
12499386,2024-08-24,RB Leipzig,VfL Bochum 1848,9,3,12
12499418,2024-08-24,SC Freiburg,VfB Stuttgart,6,3,9
12499406,2024-08-24,TSG Hoffenheim,Holstein Kiel,8,6,14
12499391,2024-08-24,Borussia Dortmund,Eintracht Frankfurt,7,7,14
12450874,2024-08-24,Paris Saint-Germain,Montpellier,10,2,12
12450881,2024-08-24,Olympique Lyonnais,AS Monaco,0,6,6
12450878,2024-08-24,Lille,Angers,3,2,5
12450877,2024-08-24,Saint-Étienne,Le Havre,2,4,6
12436888,2024-08-23,Brighton & Hove Albion,Manchester United,4,4,8
12437631,2024-08-23,Celta Vigo,Valencia,4,7,11
12437642,2024-08-23,Sevilla,Villarreal,7,2,9
12499375,2024-08-23,Borussia M'gladbach,Bayer 04 Leverkusen,2,4,6
12450874,2024-08-23,Paris Saint-Germain,Montpellier,10,2,12
12436881,2024-08-20,Leicester City,Tottenham Hotspur,2,13,15
12499260,2024-08-20,Lecce,Atalanta,5,3,8
12499258,2024-08-20,Juventus,Como,3,0,3
12437624,2024-08-20,Real Valladolid,Espanyol,3,2,5
12437610,2024-08-20,Villarreal,Atlético Madrid,2,3,5
12436879,2024-08-19,Brentford,Crystal Palace,4,7,11
12436880,2024-08-19,Chelsea,Manchester City,4,3,7
12436881,2024-08-19,Leicester City,Tottenham Hotspur,2,13,15
12499253,2024-08-19,Bologna,Udinese,9,5,14
12499257,2024-08-19,Hellas Verona,Napoli,1,5,6
12499254,2024-08-19,Cagliari,Roma,5,3,8
12499259,2024-08-19,Lazio,Venezia,6,3,9
12499260,2024-08-19,Lecce,Atalanta,5,3,8
12499258,2024-08-19,Juventus,Como,3,0,3
12437615,2024-08-19,Real Sociedad,Rayo Vallecano,10,5,15
12437606,2024-08-19,Mallorca,Real Madrid,8,7,15
12437624,2024-08-19,Real Valladolid,Espanyol,3,2,5
12437610,2024-08-19,Villarreal,Atlético Madrid,2,3,5
12450871,2024-08-19,Auxerre,Nice,3,5,8
12450867,2024-08-19,Angers,RC Lens,7,3,10
12450866,2024-08-19,Montpellier,RC Strasbourg,6,4,10
12450868,2024-08-19,Toulouse,Nantes,10,5,15
12450873,2024-08-19,Stade Rennais,Olympique Lyonnais,7,7,14
12436871,2024-08-18,Ipswich Town,Liverpool,2,10,12
12436872,2024-08-18,Arsenal,Wolverhampton,8,2,10
12436873,2024-08-18,Everton,Brighton & Hove Albion,1,5,6
12436874,2024-08-18,Newcastle United,Southampton,3,12,15
12436875,2024-08-18,Nottingham Forest,Bournemouth,2,6,8
12436877,2024-08-18,West Ham United,Aston Villa,5,3,8
12436879,2024-08-18,Brentford,Crystal Palace,4,7,11
12436880,2024-08-18,Chelsea,Manchester City,4,3,7
12499256,2024-08-18,Genoa,Inter,1,4,5
12499262,2024-08-18,Parma,Fiorentina,4,9,13
12499255,2024-08-18,Empoli,Monza,7,3,10
12499261,2024-08-18,Milan,Torino,9,2,11
12499253,2024-08-18,Bologna,Udinese,9,5,14
12499257,2024-08-18,Hellas Verona,Napoli,1,5,6
12499254,2024-08-18,Cagliari,Roma,5,3,8
12499259,2024-08-18,Lazio,Venezia,6,3,9
12437619,2024-08-18,Osasuna,Leganés,6,4,10
12437612,2024-08-18,Valencia,Barcelona,3,8,11
12437615,2024-08-18,Real Sociedad,Rayo Vallecano,10,5,15
12437606,2024-08-18,Mallorca,Real Madrid,8,7,15
12450865,2024-08-18,Stade Brestois,Olympique de Marseille,5,0,5
12450870,2024-08-18,Stade de Reims,Lille,0,8,8
12450869,2024-08-18,AS Monaco,Saint-Étienne,5,4,9
12450871,2024-08-18,Auxerre,Nice,3,5,8
12450867,2024-08-18,Angers,RC Lens,7,3,10
12450866,2024-08-18,Montpellier,RC Strasbourg,6,4,10
12450868,2024-08-18,Toulouse,Nantes,10,5,15
12450873,2024-08-18,Stade Rennais,Olympique Lyonnais,7,7,14
12436870,2024-08-17,Manchester United,Fulham,7,8,15
12436871,2024-08-17,Ipswich Town,Liverpool,2,10,12
12436872,2024-08-17,Arsenal,Wolverhampton,8,2,10
12436873,2024-08-17,Everton,Brighton & Hove Albion,1,5,6
12436874,2024-08-17,Newcastle United,Southampton,3,12,15
12436875,2024-08-17,Nottingham Forest,Bournemouth,2,6,8
12436877,2024-08-17,West Ham United,Aston Villa,5,3,8
12499256,2024-08-17,Genoa,Inter,1,4,5
12499262,2024-08-17,Parma,Fiorentina,4,9,13
12499255,2024-08-17,Empoli,Monza,7,3,10
12499261,2024-08-17,Milan,Torino,9,2,11
12437617,2024-08-17,Celta Vigo,Deportivo Alavés,3,3,6
12437608,2024-08-17,Las Palmas,Sevilla,6,3,9
12437619,2024-08-17,Osasuna,Leganés,6,4,10
12437612,2024-08-17,Valencia,Barcelona,3,8,11
12450872,2024-08-17,Le Havre,Paris Saint-Germain,2,8,10
12450865,2024-08-17,Stade Brestois,Olympique de Marseille,5,0,5
12450870,2024-08-17,Stade de Reims,Lille,0,8,8
12450869,2024-08-17,AS Monaco,Saint-Étienne,5,4,9
12436870,2024-08-16,Manchester United,Fulham,7,8,15
12436871,2024-08-16,Ipswich Town,Liverpool,2,10,12
12437604,2024-08-16,Athletic Club,Getafe,5,6,11
12437605,2024-08-16,Real Betis,Girona FC,4,4,8
12437617,2024-08-16,Celta Vigo,Deportivo Alavés,3,3,6
12437608,2024-08-16,Las Palmas,Sevilla,6,3,9
12450872,2024-08-16,Le Havre,Paris Saint-Germain,2,8,10
12437604,2024-08-15,Athletic Club,Getafe,5,6,11
12437605,2024-08-15,Real Betis,Girona FC,4,4,8
12327421,2024-06-03,Atalanta,Fiorentina,4,4,8
12290097,2024-06-03,Metz,Saint-Étienne,5,13,18
12327421,2024-06-02,Atalanta,Fiorentina,4,4,8
12290097,2024-06-02,Metz,Saint-Étienne,5,13,18
12290072,2024-05-31,Saint-Étienne,Metz,5,2,7
12290072,2024-05-30,Saint-Étienne,Metz,5,2,7
12328511,2024-05-28,Fortuna Düsseldorf,VfL Bochum 1848,14,8,22
11406730,2024-05-27,Atalanta,Torino,2,5,7
11406748,2024-05-27,Napoli,Lecce,4,1,5
11406725,2024-05-27,Empoli,Roma,4,5,9
11406726,2024-05-27,Frosinone,Udinese,11,1,12
11406724,2024-05-27,Hellas Verona,Inter,9,3,12
11406733,2024-05-27,Lazio,Sassuolo,5,3,8
11368618,2024-05-27,Getafe,Mallorca,3,4,7
11368615,2024-05-27,Celta Vigo,Valencia,2,2,4
11368632,2024-05-27,Las Palmas,Deportivo Alavés,2,6,8
11368617,2024-05-27,Sevilla,Barcelona,6,5,11
12328511,2024-05-27,Fortuna Düsseldorf,VfL Bochum 1848,14,8,22
11406722,2024-05-26,Juventus,Monza,3,4,7
11406735,2024-05-26,Milan,Salernitana,13,3,16
11406730,2024-05-26,Atalanta,Torino,2,5,7
11406748,2024-05-26,Napoli,Lecce,4,1,5
11406725,2024-05-26,Empoli,Roma,4,5,9
11406726,2024-05-26,Frosinone,Udinese,11,1,12
11406724,2024-05-26,Hellas Verona,Inter,9,3,12
11406733,2024-05-26,Lazio,Sassuolo,5,3,8
11368625,2024-05-26,Osasuna,Villarreal,6,4,10
11368623,2024-05-26,Real Sociedad,Atlético Madrid,8,4,12
11368639,2024-05-26,Almería,Cádiz,1,4,5
11368622,2024-05-26,Rayo Vallecano,Athletic Club,8,2,10
11368620,2024-05-26,Real Madrid,Real Betis,4,5,9
11368618,2024-05-26,Getafe,Mallorca,3,4,7
11368615,2024-05-26,Celta Vigo,Valencia,2,2,4
11368632,2024-05-26,Las Palmas,Deportivo Alavés,2,6,8
11368617,2024-05-26,Sevilla,Barcelona,6,5,11
11406723,2024-05-25,Genoa,Bologna,3,6,9
11406722,2024-05-25,Juventus,Monza,3,4,7
11406735,2024-05-25,Milan,Salernitana,13,3,16
11368614,2024-05-25,Girona FC,Granada,4,2,6
11368625,2024-05-25,Osasuna,Villarreal,6,4,10
11368623,2024-05-25,Real Sociedad,Atlético Madrid,8,4,12
11368639,2024-05-25,Almería,Cádiz,1,4,5
11368622,2024-05-25,Rayo Vallecano,Athletic Club,8,2,10
11368620,2024-05-25,Real Madrid,Real Betis,4,5,9
12290138,2024-05-25,Saint-Étienne,Rodez AF,14,6,20
11406729,2024-05-24,Cagliari,Fiorentina,4,5,9
11406723,2024-05-24,Genoa,Bologna,3,6,9
11368614,2024-05-24,Girona FC,Granada,4,2,6
12328472,2024-05-24,VfL Bochum 1848,Fortuna Düsseldorf,7,8,15
12290138,2024-05-24,Saint-Étienne,Rodez AF,14,6,20
11406729,2024-05-23,Cagliari,Fiorentina,4,5,9
12328472,2024-05-23,VfL Bochum 1848,Fortuna Düsseldorf,7,8,15
12290137,2024-05-22,Rodez AF,Paris FC,5,7,12
11406737,2024-05-21,Salernitana,Hellas Verona,4,6,10
11406747,2024-05-21,Bologna,Juventus,3,2,5
12290137,2024-05-21,Rodez AF,Paris FC,5,7,12
11352546,2024-05-20,Arsenal,Everton,8,1,9
11352549,2024-05-20,Brentford,Newcastle United,3,0,3
11352552,2024-05-20,Brighton & Hove Albion,Manchester United,7,5,12
11352555,2024-05-20,Burnley,Nottingham Forest,4,3,7
11352558,2024-05-20,Chelsea,Bournemouth,6,5,11
11352562,2024-05-20,Crystal Palace,Aston Villa,2,4,6
11352565,2024-05-20,Liverpool,Wolverhampton,10,2,12
11352568,2024-05-20,Luton Town,Fulham,4,4,8
11352571,2024-05-20,Manchester City,West Ham United,11,2,13
11352574,2024-05-20,Sheffield United,Tottenham Hotspur,2,6,8
11406736,2024-05-20,Sassuolo,Cagliari,5,6,11
11406732,2024-05-20,Monza,Frosinone,3,4,7
11406721,2024-05-20,Udinese,Empoli,5,5,10
11406727,2024-05-20,Inter,Lazio,8,0,8
11406731,2024-05-20,Roma,Genoa,6,3,9
11406737,2024-05-20,Salernitana,Hellas Verona,4,6,10
11406747,2024-05-20,Bologna,Juventus,3,2,5
11368624,2024-05-20,Athletic Club,Sevilla,8,3,11
11368640,2024-05-20,Atlético Madrid,Osasuna,7,5,12
11368642,2024-05-20,Barcelona,Rayo Vallecano,7,5,12
11368621,2024-05-20,Cádiz,Las Palmas,5,3,8
11368627,2024-05-20,Granada,Celta Vigo,10,2,12
11368635,2024-05-20,Mallorca,Almería,12,2,14
11368637,2024-05-20,Real Betis,Real Sociedad,6,2,8
11368638,2024-05-20,Valencia,Girona FC,5,4,9
11368619,2024-05-20,Villarreal,Real Madrid,3,3,6
11391254,2024-05-20,AS Monaco,Nantes,2,2,4
11391265,2024-05-20,Le Havre,Olympique de Marseille,5,3,8
11391257,2024-05-20,Lille,Nice,3,5,8
11391274,2024-05-20,Lorient,Clermont Foot,9,2,11
11391255,2024-05-20,Metz,Paris Saint-Germain,1,10,11
11391262,2024-05-20,Olympique Lyonnais,RC Strasbourg,7,2,9
11391282,2024-05-20,RC Lens,Montpellier,1,0,1
11391260,2024-05-20,Stade de Reims,Stade Rennais,2,4,6
11391266,2024-05-20,Toulouse,Stade Brestois,6,2,8
11352546,2024-05-19,Arsenal,Everton,8,1,9
11352549,2024-05-19,Brentford,Newcastle United,3,0,3
11352552,2024-05-19,Brighton & Hove Albion,Manchester United,7,5,12
11352555,2024-05-19,Burnley,Nottingham Forest,4,3,7
11352558,2024-05-19,Chelsea,Bournemouth,6,5,11
11352562,2024-05-19,Crystal Palace,Aston Villa,2,4,6
11352565,2024-05-19,Liverpool,Wolverhampton,10,2,12
11352568,2024-05-19,Luton Town,Fulham,4,4,8
11352571,2024-05-19,Manchester City,West Ham United,11,2,13
11352574,2024-05-19,Sheffield United,Tottenham Hotspur,2,6,8
11406742,2024-05-19,Lecce,Atalanta,2,5,7
11406744,2024-05-19,Torino,Milan,3,8,11
11406736,2024-05-19,Sassuolo,Cagliari,5,6,11
11406732,2024-05-19,Monza,Frosinone,3,4,7
11406721,2024-05-19,Udinese,Empoli,5,5,10
11406727,2024-05-19,Inter,Lazio,8,0,8
11406731,2024-05-19,Roma,Genoa,6,3,9
11368628,2024-05-19,Deportivo Alavés,Getafe,2,1,3
11368624,2024-05-19,Athletic Club,Sevilla,8,3,11
11368640,2024-05-19,Atlético Madrid,Osasuna,7,5,12
11368642,2024-05-19,Barcelona,Rayo Vallecano,7,5,12
11368621,2024-05-19,Cádiz,Las Palmas,5,3,8
11368627,2024-05-19,Granada,Celta Vigo,10,2,12
11368635,2024-05-19,Mallorca,Almería,12,2,14
11368637,2024-05-19,Real Betis,Real Sociedad,6,2,8
11368638,2024-05-19,Valencia,Girona FC,5,4,9
11368619,2024-05-19,Villarreal,Real Madrid,3,3,6
11396173,2024-05-19,1. FC Heidenheim,1. FC Köln,5,12,17
11396180,2024-05-19,1. FC Union Berlin,SC Freiburg,3,7,10
11396179,2024-05-19,Bayer 04 Leverkusen,FC Augsburg,5,4,9
11396181,2024-05-19,Borussia Dortmund,Darmstadt 98,7,3,10
11396177,2024-05-19,Eintracht Frankfurt,RB Leipzig,8,3,11
11396175,2024-05-19,SV Werder Bremen,VfL Bochum 1848,8,8,16
11396176,2024-05-19,TSG Hoffenheim,FC Bayern München,6,5,11
11396174,2024-05-19,VfB Stuttgart,Borussia M'gladbach,8,4,12
11396178,2024-05-19,VfL Wolfsburg,1. FSV Mainz 05,1,3,4
11391254,2024-05-19,AS Monaco,Nantes,2,2,4
11391265,2024-05-19,Le Havre,Olympique de Marseille,5,3,8
11391257,2024-05-19,Lille,Nice,3,5,8
11391274,2024-05-19,Lorient,Clermont Foot,9,2,11
11391255,2024-05-19,Metz,Paris Saint-Germain,1,10,11
11391262,2024-05-19,Olympique Lyonnais,RC Strasbourg,7,2,9
11391282,2024-05-19,RC Lens,Montpellier,1,0,1
11391260,2024-05-19,Stade de Reims,Stade Rennais,2,4,6
11391266,2024-05-19,Toulouse,Stade Brestois,6,2,8
11406749,2024-05-18,Fiorentina,Napoli,5,3,8
11406742,2024-05-18,Lecce,Atalanta,2,5,7
11406744,2024-05-18,Torino,Milan,3,8,11
11406736,2024-05-18,Sassuolo,Cagliari,5,6,11
11368628,2024-05-18,Deportivo Alavés,Getafe,2,1,3
11396173,2024-05-18,1. FC Heidenheim,1. FC Köln,5,12,17
11396180,2024-05-18,1. FC Union Berlin,SC Freiburg,3,7,10
11396179,2024-05-18,Bayer 04 Leverkusen,FC Augsburg,5,4,9
11396181,2024-05-18,Borussia Dortmund,Darmstadt 98,7,3,10
11396177,2024-05-18,Eintracht Frankfurt,RB Leipzig,8,3,11
11396175,2024-05-18,SV Werder Bremen,VfL Bochum 1848,8,8,16
11396176,2024-05-18,TSG Hoffenheim,FC Bayern München,6,5,11
11396174,2024-05-18,VfB Stuttgart,Borussia M'gladbach,8,4,12
11396178,2024-05-18,VfL Wolfsburg,1. FSV Mainz 05,1,3,4
11406749,2024-05-17,Fiorentina,Napoli,5,3,8
11368649,2024-05-17,Las Palmas,Real Betis,4,8,12
11368645,2024-05-17,Almería,Barcelona,4,7,11
11368648,2024-05-17,Real Sociedad,Valencia,3,3,6
12240570,2024-05-16,Brighton & Hove Albion,Chelsea,4,6,10
12240571,2024-05-16,Manchester United,Newcastle United,9,9,18
11368631,2024-05-16,Rayo Vallecano,Granada,6,6,12
11368655,2024-05-16,Sevilla,Cádiz,1,9,10
11368650,2024-05-16,Celta Vigo,Athletic Club,2,3,5
11368646,2024-05-16,Getafe,Atlético Madrid,6,3,9
11368649,2024-05-16,Las Palmas,Real Betis,4,8,12
11368645,2024-05-16,Almería,Barcelona,4,7,11
11368648,2024-05-16,Real Sociedad,Valencia,3,3,6
12268596,2024-05-16,Nice,Paris Saint-Germain,7,2,9
12268599,2024-05-16,Stade de Reims,Olympique de Marseille,3,10,13
12240634,2024-05-15,Tottenham Hotspur,Manchester City,7,4,11
12240570,2024-05-15,Brighton & Hove Albion,Chelsea,4,6,10
12240571,2024-05-15,Manchester United,Newcastle United,9,9,18
11368626,2024-05-15,Osasuna,Mallorca,2,4,6
11368616,2024-05-15,Real Madrid,Deportivo Alavés,4,1,5
11368647,2024-05-15,Girona FC,Villarreal,5,1,6
11368631,2024-05-15,Rayo Vallecano,Granada,6,6,12
11368655,2024-05-15,Sevilla,Cádiz,1,9,10
11368650,2024-05-15,Celta Vigo,Athletic Club,2,3,5
11368646,2024-05-15,Getafe,Atlético Madrid,6,3,9
12268596,2024-05-15,Nice,Paris Saint-Germain,7,2,9
12268599,2024-05-15,Stade de Reims,Olympique de Marseille,3,10,13
11352523,2024-05-14,Aston Villa,Liverpool,5,4,9
12240634,2024-05-14,Tottenham Hotspur,Manchester City,7,4,11
11406728,2024-05-14,Lecce,Udinese,8,2,10
11406765,2024-05-14,Fiorentina,Monza,6,1,7
11368630,2024-05-14,Barcelona,Real Sociedad,6,2,8
11368626,2024-05-14,Osasuna,Mallorca,2,4,6
11368616,2024-05-14,Real Madrid,Deportivo Alavés,4,1,5
11368647,2024-05-14,Girona FC,Villarreal,5,1,6
11352532,2024-05-13,Manchester United,Arsenal,4,7,11
11352523,2024-05-13,Aston Villa,Liverpool,5,4,9
11406740,2024-05-13,Lazio,Empoli,7,7,14
11406756,2024-05-13,Genoa,Sassuolo,3,7,10
11406741,2024-05-13,Hellas Verona,Torino,7,4,11
11406734,2024-05-13,Juventus,Salernitana,9,4,13
11406760,2024-05-13,Atalanta,Roma,6,1,7
11406728,2024-05-13,Lecce,Udinese,8,2,10
11406765,2024-05-13,Fiorentina,Monza,6,1,7
11368636,2024-05-13,Cádiz,Getafe,6,2,8
11368665,2024-05-13,Atlético Madrid,Celta Vigo,4,7,11
11368641,2024-05-13,Valencia,Rayo Vallecano,6,3,9
11368629,2024-05-13,Real Betis,Almería,3,5,8
11368630,2024-05-13,Barcelona,Real Sociedad,6,2,8
11396183,2024-05-13,Darmstadt 98,TSG Hoffenheim,2,3,5
11396190,2024-05-13,FC Bayern München,VfL Wolfsburg,4,0,4
11396184,2024-05-13,VfL Bochum 1848,Bayer 04 Leverkusen,2,6,8
11391273,2024-05-13,Clermont Foot,Olympique Lyonnais,7,2,9
11391283,2024-05-13,Montpellier,AS Monaco,3,3,6
11391277,2024-05-13,Nantes,Lille,5,4,9
11391264,2024-05-13,Olympique de Marseille,Lorient,9,5,14
11391267,2024-05-13,Paris Saint-Germain,Toulouse,4,6,10
11391271,2024-05-13,RC Strasbourg,Metz,3,6,9
11391258,2024-05-13,Stade Rennais,RC Lens,4,3,7
11352529,2024-05-12,Fulham,Manchester City,1,7,8
11352519,2024-05-12,Bournemouth,Brentford,3,8,11
11352527,2024-05-12,Everton,Sheffield United,3,6,9
11352536,2024-05-12,Newcastle United,Brighton & Hove Albion,8,4,12
11352542,2024-05-12,Tottenham Hotspur,Burnley,9,3,12
11352513,2024-05-12,West Ham United,Luton Town,7,6,13
11352516,2024-05-12,Wolverhampton,Crystal Palace,8,3,11
11352539,2024-05-12,Nottingham Forest,Chelsea,5,6,11
11352532,2024-05-12,Manchester United,Arsenal,4,7,11
11406738,2024-05-12,Napoli,Bologna,9,3,12
11406739,2024-05-12,Milan,Cagliari,6,3,9
11406740,2024-05-12,Lazio,Empoli,7,7,14
11406756,2024-05-12,Genoa,Sassuolo,3,7,10
11406741,2024-05-12,Hellas Verona,Torino,7,4,11
11406734,2024-05-12,Juventus,Salernitana,9,4,13
11406760,2024-05-12,Atalanta,Roma,6,1,7
11368643,2024-05-12,Mallorca,Las Palmas,2,2,4
11368644,2024-05-12,Villarreal,Sevilla,10,1,11
11368634,2024-05-12,Granada,Real Madrid,8,5,13
11368657,2024-05-12,Athletic Club,Osasuna,8,6,14
11368636,2024-05-12,Cádiz,Getafe,6,2,8
11368665,2024-05-12,Atlético Madrid,Celta Vigo,4,7,11
11368641,2024-05-12,Valencia,Rayo Vallecano,6,3,9
11368629,2024-05-12,Real Betis,Almería,3,5,8
11396185,2024-05-12,1. FC Köln,1. FC Union Berlin,6,8,14
11396186,2024-05-12,Borussia M'gladbach,Eintracht Frankfurt,2,8,10
11396189,2024-05-12,RB Leipzig,SV Werder Bremen,4,3,7
11396188,2024-05-12,SC Freiburg,1. FC Heidenheim,2,4,6
11396192,2024-05-12,1. FSV Mainz 05,Borussia Dortmund,4,2,6
11396183,2024-05-12,Darmstadt 98,TSG Hoffenheim,2,3,5
11396190,2024-05-12,FC Bayern München,VfL Wolfsburg,4,0,4
11396184,2024-05-12,VfL Bochum 1848,Bayer 04 Leverkusen,2,6,8
11391273,2024-05-12,Clermont Foot,Olympique Lyonnais,7,2,9
11391283,2024-05-12,Montpellier,AS Monaco,3,3,6
11391277,2024-05-12,Nantes,Lille,5,4,9
11391264,2024-05-12,Olympique de Marseille,Lorient,9,5,14
11391267,2024-05-12,Paris Saint-Germain,Toulouse,4,6,10
11391271,2024-05-12,RC Strasbourg,Metz,3,6,9
11391258,2024-05-12,Stade Rennais,RC Lens,4,3,7
11352529,2024-05-11,Fulham,Manchester City,1,7,8
11352519,2024-05-11,Bournemouth,Brentford,3,8,11
11352527,2024-05-11,Everton,Sheffield United,3,6,9
11352536,2024-05-11,Newcastle United,Brighton & Hove Albion,8,4,12
11352542,2024-05-11,Tottenham Hotspur,Burnley,9,3,12
11352513,2024-05-11,West Ham United,Luton Town,7,6,13
11352516,2024-05-11,Wolverhampton,Crystal Palace,8,3,11
11352539,2024-05-11,Nottingham Forest,Chelsea,5,6,11
11406763,2024-05-11,Frosinone,Inter,8,4,12
11406738,2024-05-11,Napoli,Bologna,9,3,12
11406739,2024-05-11,Milan,Cagliari,6,3,9
11406740,2024-05-11,Lazio,Empoli,7,7,14
11368633,2024-05-11,Deportivo Alavés,Girona FC,5,3,8
11368643,2024-05-11,Mallorca,Las Palmas,2,2,4
11368644,2024-05-11,Villarreal,Sevilla,10,1,11
11368634,2024-05-11,Granada,Real Madrid,8,5,13
11368657,2024-05-11,Athletic Club,Osasuna,8,6,14
11396182,2024-05-11,FC Augsburg,VfB Stuttgart,5,5,10
11396185,2024-05-11,1. FC Köln,1. FC Union Berlin,6,8,14
11396186,2024-05-11,Borussia M'gladbach,Eintracht Frankfurt,2,8,10
11396189,2024-05-11,RB Leipzig,SV Werder Bremen,4,3,7
11396188,2024-05-11,SC Freiburg,1. FC Heidenheim,2,4,6
11396192,2024-05-11,1. FSV Mainz 05,Borussia Dortmund,4,2,6
11391256,2024-05-11,Nice,Le Havre,6,1,7
11391275,2024-05-11,Stade Brestois,Stade de Reims,3,4,7
11352529,2024-05-10,Fulham,Manchester City,1,7,8
11406763,2024-05-10,Frosinone,Inter,8,4,12
11368633,2024-05-10,Deportivo Alavés,Girona FC,5,3,8
11396182,2024-05-10,FC Augsburg,VfB Stuttgart,5,5,10
11391256,2024-05-10,Nice,Le Havre,6,1,7
11391275,2024-05-10,Stade Brestois,Stade de Reims,3,4,7
12226495,2024-05-07,Crystal Palace,Manchester United,6,2,8
11406754,2024-05-07,Salernitana,Atalanta,1,7,8
11406755,2024-05-07,Udinese,Napoli,7,5,12
12268595,2024-05-07,Lille,Olympique Lyonnais,4,4,8
11352488,2024-05-06,Brighton & Hove Albion,Aston Villa,7,3,10
11352494,2024-05-06,Chelsea,West Ham United,8,6,14
11352500,2024-05-06,Liverpool,Tottenham Hotspur,8,3,11
12226495,2024-05-06,Crystal Palace,Manchester United,6,2,8
11406743,2024-05-06,Cagliari,Lecce,3,10,13
11406746,2024-05-06,Empoli,Frosinone,3,8,11
11406745,2024-05-06,Hellas Verona,Fiorentina,1,2,3
11406750,2024-05-06,Milan,Genoa,7,1,8
11406751,2024-05-06,Roma,Juventus,9,6,15
11406754,2024-05-06,Salernitana,Atalanta,1,7,8
11406755,2024-05-06,Udinese,Napoli,7,5,12
11368663,2024-05-06,Osasuna,Real Betis,8,5,13
11368654,2024-05-06,Celta Vigo,Villarreal,2,1,3
11368660,2024-05-06,Valencia,Deportivo Alavés,5,7,12
11368658,2024-05-06,Rayo Vallecano,Almería,9,2,11
11368661,2024-05-06,Sevilla,Granada,5,4,9
11396199,2024-05-06,1. FC Union Berlin,VfL Bochum 1848,6,4,10
11396198,2024-05-06,Eintracht Frankfurt,Bayer 04 Leverkusen,10,5,15
11396191,2024-05-06,1. FC Heidenheim,1. FSV Mainz 05,6,3,9
12268595,2024-05-06,Lille,Olympique Lyonnais,4,4,8
11352482,2024-05-05,Arsenal,Bournemouth,6,1,7
11352485,2024-05-05,Brentford,Fulham,7,6,13
11352491,2024-05-05,Burnley,Newcastle United,4,11,15
11352510,2024-05-05,Sheffield United,Nottingham Forest,5,3,8
11352507,2024-05-05,Manchester City,Wolverhampton,6,0,6
11352488,2024-05-05,Brighton & Hove Albion,Aston Villa,7,3,10
11352494,2024-05-05,Chelsea,West Ham United,8,6,14
11352500,2024-05-05,Liverpool,Tottenham Hotspur,8,3,11
11406752,2024-05-05,Monza,Lazio,5,4,9
11406753,2024-05-05,Sassuolo,Inter,2,5,7
11406743,2024-05-05,Cagliari,Lecce,3,10,13
11406746,2024-05-05,Empoli,Frosinone,3,8,11
11406745,2024-05-05,Hellas Verona,Fiorentina,1,2,3
11406750,2024-05-05,Milan,Genoa,7,1,8
11406751,2024-05-05,Roma,Juventus,9,6,15
11368668,2024-05-05,Real Sociedad,Las Palmas,7,2,9
11368659,2024-05-05,Real Madrid,Cádiz,7,4,11
11368667,2024-05-05,Girona FC,Barcelona,5,4,9
11368664,2024-05-05,Mallorca,Atlético Madrid,6,2,8
11368663,2024-05-05,Osasuna,Real Betis,8,5,13
11368654,2024-05-05,Celta Vigo,Villarreal,2,1,3
11368660,2024-05-05,Valencia,Deportivo Alavés,5,7,12
11368658,2024-05-05,Rayo Vallecano,Almería,9,2,11
11368661,2024-05-05,Sevilla,Granada,5,4,9
11396200,2024-05-05,Borussia Dortmund,FC Augsburg,6,9,15
11396194,2024-05-05,SV Werder Bremen,Borussia M'gladbach,7,2,9
11396193,2024-05-05,VfB Stuttgart,FC Bayern München,3,1,4
11396196,2024-05-05,VfL Wolfsburg,Darmstadt 98,9,2,11
11396197,2024-05-05,1. FC Köln,SC Freiburg,7,1,8
11396199,2024-05-05,1. FC Union Berlin,VfL Bochum 1848,6,4,10
11396198,2024-05-05,Eintracht Frankfurt,Bayer 04 Leverkusen,10,5,15
11396191,2024-05-05,1. FC Heidenheim,1. FSV Mainz 05,6,3,9
11391259,2024-05-05,Le Havre,RC Strasbourg,3,2,5
11391268,2024-05-05,AS Monaco,Clermont Foot,4,4,8
11391269,2024-05-05,Metz,Stade Rennais,2,5,7
11391261,2024-05-05,Stade Brestois,Nantes,6,0,6
11352503,2024-05-04,Luton Town,Everton,7,7,14
11352482,2024-05-04,Arsenal,Bournemouth,6,1,7
11352485,2024-05-04,Brentford,Fulham,7,6,13
11352491,2024-05-04,Burnley,Newcastle United,4,11,15
11352510,2024-05-04,Sheffield United,Nottingham Forest,5,3,8
11352507,2024-05-04,Manchester City,Wolverhampton,6,0,6
11406757,2024-05-04,Torino,Bologna,2,4,6
11406752,2024-05-04,Monza,Lazio,5,4,9
11406753,2024-05-04,Sassuolo,Inter,2,5,7
11406743,2024-05-04,Cagliari,Lecce,3,10,13
11368656,2024-05-04,Getafe,Athletic Club,10,6,16
11368668,2024-05-04,Real Sociedad,Las Palmas,7,2,9
11368659,2024-05-04,Real Madrid,Cádiz,7,4,11
11368667,2024-05-04,Girona FC,Barcelona,5,4,9
11368664,2024-05-04,Mallorca,Atlético Madrid,6,2,8
11396195,2024-05-04,TSG Hoffenheim,RB Leipzig,4,4,8
11396200,2024-05-04,Borussia Dortmund,FC Augsburg,6,9,15
11396194,2024-05-04,SV Werder Bremen,Borussia M'gladbach,7,2,9
11396193,2024-05-04,VfB Stuttgart,FC Bayern München,3,1,4
11396196,2024-05-04,VfL Wolfsburg,Darmstadt 98,9,2,11
11396197,2024-05-04,1. FC Köln,SC Freiburg,7,1,8
11391279,2024-05-04,Toulouse,Montpellier,8,0,8
11391287,2024-05-04,RC Lens,Lorient,4,4,8
11391259,2024-05-04,Le Havre,RC Strasbourg,3,2,5
11391268,2024-05-04,AS Monaco,Clermont Foot,4,4,8
11391269,2024-05-04,Metz,Stade Rennais,2,5,7
11391261,2024-05-04,Stade Brestois,Nantes,6,0,6
12226774,2024-05-03,Chelsea,Tottenham Hotspur,4,9,13
11352503,2024-05-03,Luton Town,Everton,7,7,14
11352482,2024-05-03,Arsenal,Bournemouth,6,1,7
11406757,2024-05-03,Torino,Bologna,2,4,6
11368656,2024-05-03,Getafe,Athletic Club,10,6,16
11396195,2024-05-03,TSG Hoffenheim,RB Leipzig,4,4,8
11391279,2024-05-03,Toulouse,Montpellier,8,0,8
11391287,2024-05-03,RC Lens,Lorient,4,4,8
12226774,2024-05-02,Chelsea,Tottenham Hotspur,4,9,13
11406767,2024-04-30,Genoa,Cagliari,2,4,6
12264377,2024-04-30,Barcelona,Valencia,15,1,16
11352451,2024-04-29,Bournemouth,Brighton & Hove Albion,8,2,10
11352472,2024-04-29,Tottenham Hotspur,Arsenal,8,6,14
11352470,2024-04-29,Nottingham Forest,Manchester City,4,5,9
11406778,2024-04-29,Inter,Torino,5,4,9
11406758,2024-04-29,Bologna,Udinese,10,3,13
11406759,2024-04-29,Atalanta,Empoli,8,1,9
11406772,2024-04-29,Napoli,Roma,9,2,11
11406766,2024-04-29,Fiorentina,Sassuolo,10,2,12
11406767,2024-04-29,Genoa,Cagliari,2,4,6
11368675,2024-04-29,Cádiz,Mallorca,3,1,4
11368674,2024-04-29,Granada,Osasuna,0,6,6
11368652,2024-04-29,Villarreal,Rayo Vallecano,3,6,9
11368677,2024-04-29,Real Betis,Sevilla,4,6,10
12264377,2024-04-29,Barcelona,Valencia,15,1,16
11396204,2024-04-29,Borussia M'gladbach,1. FC Union Berlin,3,4,7
11396205,2024-04-29,1. FSV Mainz 05,1. FC Köln,6,6,12
11396201,2024-04-29,Darmstadt 98,1. FC Heidenheim,3,8,11
11391281,2024-04-29,Metz,Lille,2,4,6
11391270,2024-04-29,Clermont Foot,Stade de Reims,5,5,10
11391280,2024-04-29,Lorient,Toulouse,5,1,6
11391299,2024-04-29,RC Strasbourg,Nice,2,3,5
11391272,2024-04-29,Stade Rennais,Stade Brestois,7,4,11
11391263,2024-04-29,Olympique Lyonnais,AS Monaco,3,3,6
11391276,2024-04-29,Olympique de Marseille,RC Lens,3,11,14
11352476,2024-04-28,West Ham United,Liverpool,4,8,12
11352460,2024-04-28,Fulham,Crystal Palace,5,9,14
11352463,2024-04-28,Manchester United,Burnley,6,5,11
11352467,2024-04-28,Newcastle United,Sheffield United,4,5,9
11352479,2024-04-28,Wolverhampton,Luton Town,4,4,8
11352457,2024-04-28,Everton,Brentford,6,6,12
11352454,2024-04-28,Aston Villa,Chelsea,2,4,6
11352451,2024-04-28,Bournemouth,Brighton & Hove Albion,8,2,10
11352472,2024-04-28,Tottenham Hotspur,Arsenal,8,6,14
11352470,2024-04-28,Nottingham Forest,Manchester City,4,5,9
11406769,2024-04-28,Lecce,Monza,0,5,5
11406771,2024-04-28,Juventus,Milan,9,4,13
11406768,2024-04-28,Lazio,Hellas Verona,4,2,6
11406778,2024-04-28,Inter,Torino,5,4,9
11406758,2024-04-28,Bologna,Udinese,10,3,13
11406759,2024-04-28,Atalanta,Empoli,8,1,9
11406772,2024-04-28,Napoli,Roma,9,2,11
11406766,2024-04-28,Fiorentina,Sassuolo,10,2,12
11368651,2024-04-28,Las Palmas,Girona FC,4,2,6
11368673,2024-04-28,Almería,Getafe,9,2,11
11368678,2024-04-28,Deportivo Alavés,Celta Vigo,8,3,11
11368679,2024-04-28,Atlético Madrid,Athletic Club,3,5,8
11368675,2024-04-28,Cádiz,Mallorca,3,1,4
11368674,2024-04-28,Granada,Osasuna,0,6,6
11368652,2024-04-28,Villarreal,Rayo Vallecano,3,6,9
11368677,2024-04-28,Real Betis,Sevilla,4,6,10
11396202,2024-04-28,FC Augsburg,SV Werder Bremen,6,4,10
11396209,2024-04-28,FC Bayern München,Eintracht Frankfurt,4,2,6
11396208,2024-04-28,RB Leipzig,Borussia Dortmund,5,8,13
11396207,2024-04-28,SC Freiburg,VfL Wolfsburg,3,6,9
11396206,2024-04-28,Bayer 04 Leverkusen,VfB Stuttgart,5,2,7
11396204,2024-04-28,Borussia M'gladbach,1. FC Union Berlin,3,4,7
11396205,2024-04-28,1. FSV Mainz 05,1. FC Köln,6,6,12
11396201,2024-04-28,Darmstadt 98,1. FC Heidenheim,3,8,11
11391300,2024-04-28,Paris Saint-Germain,Le Havre,11,2,13
11391281,2024-04-28,Metz,Lille,2,4,6
11391270,2024-04-28,Clermont Foot,Stade de Reims,5,5,10
11391280,2024-04-28,Lorient,Toulouse,5,1,6
11391299,2024-04-28,RC Strasbourg,Nice,2,3,5
11391272,2024-04-28,Stade Rennais,Stade Brestois,7,4,11
11391263,2024-04-28,Olympique Lyonnais,AS Monaco,3,3,6
11391276,2024-04-28,Olympique de Marseille,RC Lens,3,11,14
11352476,2024-04-27,West Ham United,Liverpool,4,8,12
11352460,2024-04-27,Fulham,Crystal Palace,5,9,14
11352463,2024-04-27,Manchester United,Burnley,6,5,11
11352467,2024-04-27,Newcastle United,Sheffield United,4,5,9
11352479,2024-04-27,Wolverhampton,Luton Town,4,4,8
11352457,2024-04-27,Everton,Brentford,6,6,12
11352454,2024-04-27,Aston Villa,Chelsea,2,4,6
11406770,2024-04-27,Frosinone,Salernitana,7,3,10
11406769,2024-04-27,Lecce,Monza,0,5,5
11406771,2024-04-27,Juventus,Milan,9,4,13
11406768,2024-04-27,Lazio,Hellas Verona,4,2,6
11406778,2024-04-27,Inter,Torino,5,4,9
11368653,2024-04-27,Real Sociedad,Real Madrid,11,3,14
11368651,2024-04-27,Las Palmas,Girona FC,4,2,6
11368673,2024-04-27,Almería,Getafe,9,2,11
11368678,2024-04-27,Deportivo Alavés,Celta Vigo,8,3,11
11368679,2024-04-27,Atlético Madrid,Athletic Club,3,5,8
11396203,2024-04-27,VfL Bochum 1848,TSG Hoffenheim,10,4,14
11396202,2024-04-27,FC Augsburg,SV Werder Bremen,6,4,10
11396209,2024-04-27,FC Bayern München,Eintracht Frankfurt,4,2,6
11396208,2024-04-27,RB Leipzig,Borussia Dortmund,5,8,13
11396207,2024-04-27,SC Freiburg,VfL Wolfsburg,3,6,9
11396206,2024-04-27,Bayer 04 Leverkusen,VfB Stuttgart,5,2,7
11391278,2024-04-27,Montpellier,Nantes,3,6,9
11391300,2024-04-27,Paris Saint-Germain,Le Havre,11,2,13
11391281,2024-04-27,Metz,Lille,2,4,6
12190341,2024-04-26,Brighton & Hove Albion,Manchester City,4,4,8
11352476,2024-04-26,West Ham United,Liverpool,4,8,12
11406783,2024-04-26,Udinese,Roma,4,8,12
11406770,2024-04-26,Frosinone,Salernitana,7,3,10
11368653,2024-04-26,Real Sociedad,Real Madrid,11,3,14
11396203,2024-04-26,VfL Bochum 1848,TSG Hoffenheim,10,4,14
11391278,2024-04-26,Montpellier,Nantes,3,6,9
12190332,2024-04-25,Wolverhampton,Bournemouth,8,12,20
12190340,2024-04-25,Crystal Palace,Newcastle United,7,2,9
12190339,2024-04-25,Everton,Liverpool,4,13,17
12190336,2024-04-25,Manchester United,Sheffield United,8,4,12
12190341,2024-04-25,Brighton & Hove Albion,Manchester City,4,4,8
11406783,2024-04-25,Udinese,Roma,4,8,12
12181413,2024-04-25,Lorient,Paris Saint-Germain,3,6,9
12184778,2024-04-25,AS Monaco,Lille,7,5,12
12184790,2024-04-25,Olympique de Marseille,Nice,3,2,5
12190322,2024-04-24,Arsenal,Chelsea,4,2,6
12190332,2024-04-24,Wolverhampton,Bournemouth,8,12,20
12190340,2024-04-24,Crystal Palace,Newcastle United,7,2,9
12190339,2024-04-24,Everton,Liverpool,4,13,17
12190336,2024-04-24,Manchester United,Sheffield United,8,4,12
12181413,2024-04-24,Lorient,Paris Saint-Germain,3,6,9
12184778,2024-04-24,AS Monaco,Lille,7,5,12
12184790,2024-04-24,Olympique de Marseille,Nice,3,2,5
12190322,2024-04-23,Arsenal,Chelsea,4,2,6
11406789,2024-04-23,Roma,Bologna,8,2,10
11406782,2024-04-23,Milan,Inter,5,3,8
11368680,2024-04-23,Sevilla,Mallorca,4,4,8
11352429,2024-04-22,Everton,Nottingham Forest,6,4,10
11352420,2024-04-22,Aston Villa,Bournemouth,8,4,12
11352425,2024-04-22,Crystal Palace,West Ham United,4,0,4
11352432,2024-04-22,Fulham,Liverpool,1,4,5
11406761,2024-04-22,Sassuolo,Lecce,9,4,13
11406762,2024-04-22,Torino,Frosinone,6,4,10
11406764,2024-04-22,Salernitana,Fiorentina,2,5,7
11406786,2024-04-22,Monza,Atalanta,2,8,10
11406789,2024-04-22,Roma,Bologna,8,2,10
11406782,2024-04-22,Milan,Inter,5,3,8
11368662,2024-04-22,Getafe,Real Sociedad,0,4,4
11368688,2024-04-22,Almería,Villarreal,5,2,7
11368666,2024-04-22,Deportivo Alavés,Atlético Madrid,1,11,12
11368670,2024-04-22,Real Madrid,Barcelona,2,8,10
11368680,2024-04-22,Sevilla,Mallorca,4,4,8
11396212,2024-04-22,SV Werder Bremen,VfB Stuttgart,1,7,8
11396218,2024-04-22,Borussia Dortmund,Bayer 04 Leverkusen,2,6,8
11396216,2024-04-22,SC Freiburg,1. FSV Mainz 05,2,4,6
11391294,2024-04-22,Le Havre,Metz,4,2,6
11391293,2024-04-22,Lille,RC Strasbourg,4,4,8
11391292,2024-04-22,Stade de Reims,Montpellier,8,4,12
11391297,2024-04-22,Stade Brestois,AS Monaco,7,4,11
11391290,2024-04-22,Toulouse,Olympique de Marseille,7,4,11
11391289,2024-04-22,Paris Saint-Germain,Olympique Lyonnais,4,10,14
11352434,2024-04-21,Luton Town,Brentford,4,9,13
11352441,2024-04-21,Sheffield United,Burnley,11,2,13
11352448,2024-04-21,Wolverhampton,Arsenal,1,2,3
11352429,2024-04-21,Everton,Nottingham Forest,6,4,10
11352420,2024-04-21,Aston Villa,Bournemouth,8,4,12
11352425,2024-04-21,Crystal Palace,West Ham United,4,0,4
11352432,2024-04-21,Fulham,Liverpool,1,4,5
11406781,2024-04-21,Empoli,Napoli,2,8,10
11406785,2024-04-21,Hellas Verona,Udinese,10,6,16
11406761,2024-04-21,Sassuolo,Lecce,9,4,13
11406762,2024-04-21,Torino,Frosinone,6,4,10
11406764,2024-04-21,Salernitana,Fiorentina,2,5,7
11406786,2024-04-21,Monza,Atalanta,2,8,10
11368689,2024-04-21,Celta Vigo,Las Palmas,8,4,12
11368669,2024-04-21,Rayo Vallecano,Osasuna,5,1,6
11368671,2024-04-21,Valencia,Real Betis,7,6,13
11368676,2024-04-21,Girona FC,Cádiz,2,4,6
11368662,2024-04-21,Getafe,Real Sociedad,0,4,4
11368688,2024-04-21,Almería,Villarreal,5,2,7
11368666,2024-04-21,Deportivo Alavés,Atlético Madrid,1,11,12
11368670,2024-04-21,Real Madrid,Barcelona,2,8,10
11396210,2024-04-21,1. FC Heidenheim,RB Leipzig,2,6,8
11396214,2024-04-21,1. FC Köln,Darmstadt 98,4,3,7
11396211,2024-04-21,TSG Hoffenheim,Borussia M'gladbach,6,5,11
11396213,2024-04-21,VfL Wolfsburg,VfL Bochum 1848,5,8,13
11396217,2024-04-21,1. FC Union Berlin,FC Bayern München,5,3,8
11396212,2024-04-21,SV Werder Bremen,VfB Stuttgart,1,7,8
11396218,2024-04-21,Borussia Dortmund,Bayer 04 Leverkusen,2,6,8
11396216,2024-04-21,SC Freiburg,1. FSV Mainz 05,2,4,6
11391298,2024-04-21,Nantes,Stade Rennais,3,7,10
11391295,2024-04-21,RC Lens,Clermont Foot,4,3,7
11391294,2024-04-21,Le Havre,Metz,4,2,6
11391293,2024-04-21,Lille,RC Strasbourg,4,4,8
11391292,2024-04-21,Stade de Reims,Montpellier,8,4,12
11391297,2024-04-21,Stade Brestois,AS Monaco,7,4,11
11391290,2024-04-21,Toulouse,Olympique de Marseille,7,4,11
11391289,2024-04-21,Paris Saint-Germain,Olympique Lyonnais,4,10,14
11352434,2024-04-20,Luton Town,Brentford,4,9,13
11352441,2024-04-20,Sheffield United,Burnley,11,2,13
11352448,2024-04-20,Wolverhampton,Arsenal,1,2,3
11406784,2024-04-20,Genoa,Lazio,2,9,11
11406779,2024-04-20,Cagliari,Juventus,4,3,7
11406781,2024-04-20,Empoli,Napoli,2,8,10
11406785,2024-04-20,Hellas Verona,Udinese,10,6,16
11406761,2024-04-20,Sassuolo,Lecce,9,4,13
11368690,2024-04-20,Athletic Club,Granada,11,4,15
11368689,2024-04-20,Celta Vigo,Las Palmas,8,4,12
11368669,2024-04-20,Rayo Vallecano,Osasuna,5,1,6
11368671,2024-04-20,Valencia,Real Betis,7,6,13
11368676,2024-04-20,Girona FC,Cádiz,2,4,6
11396215,2024-04-20,Eintracht Frankfurt,FC Augsburg,6,5,11
11396210,2024-04-20,1. FC Heidenheim,RB Leipzig,2,6,8
11396214,2024-04-20,1. FC Köln,Darmstadt 98,4,3,7
11396211,2024-04-20,TSG Hoffenheim,Borussia M'gladbach,6,5,11
11396213,2024-04-20,VfL Wolfsburg,VfL Bochum 1848,5,8,13
11396217,2024-04-20,1. FC Union Berlin,FC Bayern München,5,3,8
11391296,2024-04-20,Nice,Lorient,2,3,5
11391298,2024-04-20,Nantes,Stade Rennais,3,7,10
11391295,2024-04-20,RC Lens,Clermont Foot,4,3,7
11406784,2024-04-19,Genoa,Lazio,2,9,11
11406779,2024-04-19,Cagliari,Juventus,4,3,7
11368690,2024-04-19,Athletic Club,Granada,11,4,15
11396215,2024-04-19,Eintracht Frankfurt,FC Augsburg,6,5,11
11391296,2024-04-19,Nice,Lorient,2,3,5
11352401,2024-04-16,Chelsea,Everton,4,8,12
11406798,2024-04-16,Fiorentina,Genoa,6,2,8
11406797,2024-04-16,Atalanta,Hellas Verona,5,4,9
11368687,2024-04-16,Osasuna,Valencia,4,1,5
11352403,2024-04-15,Liverpool,Crystal Palace,11,1,12
11352416,2024-04-15,West Ham United,Fulham,8,3,11
11352390,2024-04-15,Arsenal,Aston Villa,4,6,10
11352401,2024-04-15,Chelsea,Everton,4,8,12
11406777,2024-04-15,Napoli,Frosinone,6,2,8
11406775,2024-04-15,Sassuolo,Milan,2,6,8
11406773,2024-04-15,Inter,Cagliari,7,0,7
11406798,2024-04-15,Fiorentina,Genoa,6,2,8
11406797,2024-04-15,Atalanta,Hellas Verona,5,4,9
11368682,2024-04-15,Las Palmas,Sevilla,6,2,8
11368686,2024-04-15,Granada,Deportivo Alavés,1,5,6
11368702,2024-04-15,Athletic Club,Villarreal,3,1,4
11368683,2024-04-15,Real Sociedad,Almería,5,1,6
11368687,2024-04-15,Osasuna,Valencia,4,1,5
11396219,2024-04-15,Darmstadt 98,SC Freiburg,2,2,4
11396228,2024-04-15,Bayer 04 Leverkusen,SV Werder Bremen,7,0,7
11391291,2024-04-15,Le Havre,Nantes,6,7,13
11391314,2024-04-15,Clermont Foot,Montpellier,3,4,7
11391311,2024-04-15,Olympique Lyonnais,Stade Brestois,10,7,17
11352410,2024-04-14,Newcastle United,Tottenham Hotspur,16,3,19
11352394,2024-04-14,Brentford,Sheffield United,3,6,9
11352397,2024-04-14,Burnley,Brighton & Hove Albion,4,5,9
11352406,2024-04-14,Manchester City,Luton Town,12,1,13
11352413,2024-04-14,Nottingham Forest,Wolverhampton,10,1,11
11352387,2024-04-14,Bournemouth,Manchester United,7,2,9
11352403,2024-04-14,Liverpool,Crystal Palace,11,1,12
11352416,2024-04-14,West Ham United,Fulham,8,3,11
11352390,2024-04-14,Arsenal,Aston Villa,4,6,10
11406774,2024-04-14,Lecce,Empoli,10,3,13
11406780,2024-04-14,Torino,Juventus,6,2,8
11406803,2024-04-14,Bologna,Monza,10,0,10
11406777,2024-04-14,Napoli,Frosinone,6,2,8
11406775,2024-04-14,Sassuolo,Milan,2,6,8
11406773,2024-04-14,Inter,Cagliari,7,0,7
11368696,2024-04-14,Atlético Madrid,Girona FC,2,0,2
11368684,2024-04-14,Rayo Vallecano,Getafe,3,0,3
11368681,2024-04-14,Mallorca,Real Madrid,4,2,6
11368685,2024-04-14,Cádiz,Barcelona,8,4,12
11368682,2024-04-14,Las Palmas,Sevilla,6,2,8
11368686,2024-04-14,Granada,Deportivo Alavés,1,5,6
11368702,2024-04-14,Athletic Club,Villarreal,3,1,4
11368683,2024-04-14,Real Sociedad,Almería,5,1,6
11396224,2024-04-14,1. FSV Mainz 05,TSG Hoffenheim,9,3,12
11396223,2024-04-14,Borussia M'gladbach,Borussia Dortmund,2,4,6
11396227,2024-04-14,FC Bayern München,1. FC Köln,5,5,10
11396225,2024-04-14,RB Leipzig,VfL Wolfsburg,6,4,10
11396222,2024-04-14,VfL Bochum 1848,1. FC Heidenheim,6,2,8
11396220,2024-04-14,VfB Stuttgart,Eintracht Frankfurt,4,5,9
11396219,2024-04-14,Darmstadt 98,SC Freiburg,2,2,4
11396228,2024-04-14,Bayer 04 Leverkusen,SV Werder Bremen,7,0,7
11391309,2024-04-14,RC Strasbourg,Stade de Reims,5,4,9
11391307,2024-04-14,Stade Rennais,Toulouse,8,4,12
11391291,2024-04-14,Le Havre,Nantes,6,7,13
11391314,2024-04-14,Clermont Foot,Montpellier,3,4,7
11391311,2024-04-14,Olympique Lyonnais,Stade Brestois,10,7,17
11352410,2024-04-13,Newcastle United,Tottenham Hotspur,16,3,19
11352394,2024-04-13,Brentford,Sheffield United,3,6,9
11352397,2024-04-13,Burnley,Brighton & Hove Albion,4,5,9
11352406,2024-04-13,Manchester City,Luton Town,12,1,13
11352413,2024-04-13,Nottingham Forest,Wolverhampton,10,1,11
11352387,2024-04-13,Bournemouth,Manchester United,7,2,9
11406776,2024-04-13,Lazio,Salernitana,9,0,9
11406774,2024-04-13,Lecce,Empoli,10,3,13
11406780,2024-04-13,Torino,Juventus,6,2,8
11406803,2024-04-13,Bologna,Monza,10,0,10
11406777,2024-04-13,Napoli,Frosinone,6,2,8
11368709,2024-04-13,Real Betis,Celta Vigo,6,5,11
11368696,2024-04-13,Atlético Madrid,Girona FC,2,0,2
11368684,2024-04-13,Rayo Vallecano,Getafe,3,0,3
11368681,2024-04-13,Mallorca,Real Madrid,4,2,6
11368685,2024-04-13,Cádiz,Barcelona,8,4,12
11396221,2024-04-13,FC Augsburg,1. FC Union Berlin,5,4,9
11396224,2024-04-13,1. FSV Mainz 05,TSG Hoffenheim,9,3,12
11396223,2024-04-13,Borussia M'gladbach,Borussia Dortmund,2,4,6
11396227,2024-04-13,FC Bayern München,1. FC Köln,5,5,10
11396225,2024-04-13,RB Leipzig,VfL Wolfsburg,6,4,10
11396222,2024-04-13,VfL Bochum 1848,1. FC Heidenheim,6,2,8
11396220,2024-04-13,VfB Stuttgart,Eintracht Frankfurt,4,5,9
11391288,2024-04-13,Metz,RC Lens,5,2,7
11391309,2024-04-13,RC Strasbourg,Stade de Reims,5,4,9
11391307,2024-04-13,Stade Rennais,Toulouse,8,4,12
11391291,2024-04-13,Le Havre,Nantes,6,7,13
11352410,2024-04-12,Newcastle United,Tottenham Hotspur,16,3,19
11406776,2024-04-12,Lazio,Salernitana,9,0,9
11368709,2024-04-12,Real Betis,Celta Vigo,6,5,11
11396221,2024-04-12,FC Augsburg,1. FC Union Berlin,5,4,9
11391288,2024-04-12,Metz,RC Lens,5,2,7
11406796,2024-04-09,Udinese,Inter,0,8,8
11352374,2024-04-08,Manchester United,Liverpool,6,11,17
11352378,2024-04-08,Sheffield United,Chelsea,7,6,13
11352381,2024-04-08,Tottenham Hotspur,Nottingham Forest,12,2,14
11406791,2024-04-08,Frosinone,Bologna,5,2,7
11406788,2024-04-08,Monza,Napoli,1,6,7
11406812,2024-04-08,Cagliari,Atalanta,4,4,8
11406787,2024-04-08,Hellas Verona,Genoa,5,3,8
11406794,2024-04-08,Juventus,Fiorentina,5,6,11
11406796,2024-04-08,Udinese,Inter,0,8,8
11396229,2024-04-08,TSG Hoffenheim,FC Augsburg,11,6,17
11396231,2024-04-08,VfL Wolfsburg,Borussia M'gladbach,4,4,8
11391308,2024-04-08,Stade Brestois,Metz,8,5,13
11391306,2024-04-08,Montpellier,Lorient,5,7,12
11391305,2024-04-08,Stade de Reims,Nice,2,5,7
11391328,2024-04-08,Toulouse,RC Strasbourg,4,3,7
11391301,2024-04-08,AS Monaco,Stade Rennais,6,3,9
11391304,2024-04-08,Nantes,Olympique Lyonnais,5,5,10
11352362,2024-04-07,Crystal Palace,Manchester City,2,9,11
11352355,2024-04-07,Aston Villa,Brentford,11,3,14
11352364,2024-04-07,Everton,Burnley,3,5,8
11352368,2024-04-07,Fulham,Newcastle United,14,3,17
11352371,2024-04-07,Luton Town,Bournemouth,7,2,9
11352384,2024-04-07,Wolverhampton,West Ham United,4,4,8
11352359,2024-04-07,Brighton & Hove Albion,Arsenal,8,7,15
11352374,2024-04-07,Manchester United,Liverpool,6,11,17
11352378,2024-04-07,Sheffield United,Chelsea,7,6,13
11352381,2024-04-07,Tottenham Hotspur,Nottingham Forest,12,2,14
11406793,2024-04-07,Milan,Lecce,5,1,6
11406792,2024-04-07,Roma,Lazio,3,6,9
11406790,2024-04-07,Empoli,Torino,1,7,8
11406791,2024-04-07,Frosinone,Bologna,5,2,7
11406788,2024-04-07,Monza,Napoli,1,6,7
11406812,2024-04-07,Cagliari,Atalanta,4,4,8
11406787,2024-04-07,Hellas Verona,Genoa,5,3,8
11406794,2024-04-07,Juventus,Fiorentina,5,6,11
11396226,2024-04-07,1. FC Heidenheim,FC Bayern München,3,3,6
11396230,2024-04-07,1. FC Köln,VfL Bochum 1848,9,4,13
11396235,2024-04-07,1. FC Union Berlin,Bayer 04 Leverkusen,7,10,17
11396232,2024-04-07,1. FSV Mainz 05,Darmstadt 98,5,1,6
11396233,2024-04-07,SC Freiburg,RB Leipzig,8,4,12
11396236,2024-04-07,Borussia Dortmund,VfB Stuttgart,8,3,11
11396229,2024-04-07,TSG Hoffenheim,FC Augsburg,11,6,17
11396231,2024-04-07,VfL Wolfsburg,Borussia M'gladbach,4,4,8
11391303,2024-04-07,RC Lens,Le Havre,7,4,11
11391326,2024-04-07,Paris Saint-Germain,Clermont Foot,17,2,19
11391308,2024-04-07,Stade Brestois,Metz,8,5,13
11391306,2024-04-07,Montpellier,Lorient,5,7,12
11391305,2024-04-07,Stade de Reims,Nice,2,5,7
11391328,2024-04-07,Toulouse,RC Strasbourg,4,3,7
11391301,2024-04-07,AS Monaco,Stade Rennais,6,3,9
11391304,2024-04-07,Nantes,Olympique Lyonnais,5,5,10
11352362,2024-04-06,Crystal Palace,Manchester City,2,9,11
11352355,2024-04-06,Aston Villa,Brentford,11,3,14
11352364,2024-04-06,Everton,Burnley,3,5,8
11352368,2024-04-06,Fulham,Newcastle United,14,3,17
11352371,2024-04-06,Luton Town,Bournemouth,7,2,9
11352384,2024-04-06,Wolverhampton,West Ham United,4,4,8
11352359,2024-04-06,Brighton & Hove Albion,Arsenal,8,7,15
11406795,2024-04-06,Salernitana,Sassuolo,4,9,13
11406793,2024-04-06,Milan,Lecce,5,1,6
11406792,2024-04-06,Roma,Lazio,3,6,9
11406790,2024-04-06,Empoli,Torino,1,7,8
11406791,2024-04-06,Frosinone,Bologna,5,2,7
11396234,2024-04-06,Eintracht Frankfurt,SV Werder Bremen,9,0,9
11396226,2024-04-06,1. FC Heidenheim,FC Bayern München,3,3,6
11396230,2024-04-06,1. FC Köln,VfL Bochum 1848,9,4,13
11396235,2024-04-06,1. FC Union Berlin,Bayer 04 Leverkusen,7,10,17
11396232,2024-04-06,1. FSV Mainz 05,Darmstadt 98,5,1,6
11396233,2024-04-06,SC Freiburg,RB Leipzig,8,4,12
11396236,2024-04-06,Borussia Dortmund,VfB Stuttgart,8,3,11
11391302,2024-04-06,Lille,Olympique de Marseille,4,2,6
11391303,2024-04-06,RC Lens,Le Havre,7,4,11
11391326,2024-04-06,Paris Saint-Germain,Clermont Foot,17,2,19
11391308,2024-04-06,Stade Brestois,Metz,8,5,13
11352347,2024-04-05,Liverpool,Sheffield United,13,1,14
11352340,2024-04-05,Chelsea,Manchester United,12,3,15
11352362,2024-04-05,Crystal Palace,Manchester City,2,9,11
11406795,2024-04-05,Salernitana,Sassuolo,4,9,13
12114515,2024-04-05,Granada,Valencia,5,4,9
11396234,2024-04-05,Eintracht Frankfurt,SV Werder Bremen,9,0,9
11391302,2024-04-05,Lille,Olympique de Marseille,4,2,6
11352322,2024-04-04,Arsenal,Luton Town,3,1,4
11352325,2024-04-04,Brentford,Brighton & Hove Albion,1,5,6
11352352,2024-04-04,Manchester City,Aston Villa,2,3,5
11352347,2024-04-04,Liverpool,Sheffield United,13,1,14
11352340,2024-04-04,Chelsea,Manchester United,12,3,15
12114515,2024-04-04,Granada,Valencia,5,4,9
11352343,2024-04-03,Newcastle United,Everton,7,3,10
11352333,2024-04-03,Nottingham Forest,Fulham,3,8,11
11352319,2024-04-03,Bournemouth,Crystal Palace,9,2,11
11352330,2024-04-03,Burnley,Wolverhampton,7,4,11
11352336,2024-04-03,West Ham United,Tottenham Hotspur,9,5,14
11352322,2024-04-03,Arsenal,Luton Town,3,1,4
11352325,2024-04-03,Brentford,Brighton & Hove Albion,1,5,6
11352352,2024-04-03,Manchester City,Aston Villa,2,3,5
11352343,2024-04-02,Newcastle United,Everton,7,3,10
11352333,2024-04-02,Nottingham Forest,Fulham,3,8,11
11352319,2024-04-02,Bournemouth,Crystal Palace,9,2,11
11352330,2024-04-02,Burnley,Wolverhampton,7,4,11
11352336,2024-04-02,West Ham United,Tottenham Hotspur,9,5,14
11406799,2024-04-02,Bologna,Salernitana,5,3,8
11406801,2024-04-02,Cagliari,Hellas Verona,7,2,9
11406816,2024-04-02,Sassuolo,Udinese,10,1,11
11406808,2024-04-02,Lecce,Roma,8,4,12
11406805,2024-04-02,Inter,Empoli,8,6,14
11368695,2024-04-02,Villarreal,Atlético Madrid,3,3,6
11352617,2024-04-01,Liverpool,Brighton & Hove Albion,8,4,12
11352619,2024-04-01,Manchester City,Arsenal,7,4,11
11406799,2024-04-01,Bologna,Salernitana,5,3,8
11406801,2024-04-01,Cagliari,Hellas Verona,7,2,9
11406816,2024-04-01,Sassuolo,Udinese,10,1,11
11406808,2024-04-01,Lecce,Roma,8,4,12
11406805,2024-04-01,Inter,Empoli,8,6,14
11368692,2024-04-01,Celta Vigo,Rayo Vallecano,3,2,5
11368693,2024-04-01,Girona FC,Real Betis,5,4,9
11368694,2024-04-01,Deportivo Alavés,Real Sociedad,3,8,11
11368707,2024-04-01,Real Madrid,Athletic Club,4,7,11
11368695,2024-04-01,Villarreal,Atlético Madrid,3,3,6
11396238,2024-04-01,FC Augsburg,1. FC Köln,12,6,18
11396237,2024-04-01,VfB Stuttgart,1. FC Heidenheim,6,7,13
11396239,2024-04-01,VfL Bochum 1848,Darmstadt 98,6,5,11
11391317,2024-04-01,Lorient,Stade Brestois,6,4,10
11391319,2024-04-01,Clermont Foot,Toulouse,12,3,15
11391327,2024-04-01,Le Havre,Montpellier,6,6,12
11391323,2024-04-01,Nice,Nantes,9,3,12
11391318,2024-04-01,RC Strasbourg,Stade Rennais,4,5,9
11391320,2024-04-01,Olympique de Marseille,Paris Saint-Germain,5,3,8
11352620,2024-03-31,Newcastle United,West Ham United,3,4,7
11352612,2024-03-31,Bournemouth,Everton,9,8,17
11352616,2024-03-31,Chelsea,Burnley,12,4,16
11352622,2024-03-31,Nottingham Forest,Crystal Palace,4,6,10
11352623,2024-03-31,Sheffield United,Fulham,2,15,17
11352624,2024-03-31,Tottenham Hotspur,Luton Town,3,6,9
11352613,2024-03-31,Aston Villa,Wolverhampton,5,4,9
11352614,2024-03-31,Brentford,Manchester United,14,4,18
11352617,2024-03-31,Liverpool,Brighton & Hove Albion,8,4,12
11352619,2024-03-31,Manchester City,Arsenal,7,4,11
11406806,2024-03-31,Napoli,Atalanta,7,5,12
11406814,2024-03-31,Genoa,Frosinone,3,8,11
11406810,2024-03-31,Torino,Monza,7,2,9
11406809,2024-03-31,Lazio,Juventus,7,2,9
11406804,2024-03-31,Fiorentina,Milan,7,5,12
11406799,2024-03-31,Bologna,Salernitana,5,3,8
11368691,2024-03-31,Getafe,Sevilla,6,3,9
11368706,2024-03-31,Almería,Osasuna,6,1,7
11368697,2024-03-31,Valencia,Mallorca,3,3,6
11368704,2024-03-31,Barcelona,Las Palmas,6,1,7
11368692,2024-03-31,Celta Vigo,Rayo Vallecano,3,2,5
11368693,2024-03-31,Girona FC,Real Betis,5,4,9
11368694,2024-03-31,Deportivo Alavés,Real Sociedad,3,8,11
11368707,2024-03-31,Real Madrid,Athletic Club,4,7,11
11396243,2024-03-31,Bayer 04 Leverkusen,TSG Hoffenheim,9,2,11
11396241,2024-03-31,Borussia M'gladbach,SC Freiburg,14,1,15
11396242,2024-03-31,Eintracht Frankfurt,1. FC Union Berlin,6,2,8
11396244,2024-03-31,RB Leipzig,1. FSV Mainz 05,12,2,14
11396240,2024-03-31,SV Werder Bremen,VfL Wolfsburg,3,6,9
11396245,2024-03-31,FC Bayern München,Borussia Dortmund,7,4,11
11396238,2024-03-31,FC Augsburg,1. FC Köln,12,6,18
11396237,2024-03-31,VfB Stuttgart,1. FC Heidenheim,6,7,13
11396239,2024-03-31,VfL Bochum 1848,Darmstadt 98,6,5,11
11391322,2024-03-31,Metz,AS Monaco,5,5,10
11391316,2024-03-31,Olympique Lyonnais,Stade de Reims,7,8,15
11391317,2024-03-31,Lorient,Stade Brestois,6,4,10
11391319,2024-03-31,Clermont Foot,Toulouse,12,3,15
11391327,2024-03-31,Le Havre,Montpellier,6,6,12
11391323,2024-03-31,Nice,Nantes,9,3,12
11391318,2024-03-31,RC Strasbourg,Stade Rennais,4,5,9
11391320,2024-03-31,Olympique de Marseille,Paris Saint-Germain,5,3,8
11352620,2024-03-30,Newcastle United,West Ham United,3,4,7
11352612,2024-03-30,Bournemouth,Everton,9,8,17
11352616,2024-03-30,Chelsea,Burnley,12,4,16
11352622,2024-03-30,Nottingham Forest,Crystal Palace,4,6,10
11352623,2024-03-30,Sheffield United,Fulham,2,15,17
11352624,2024-03-30,Tottenham Hotspur,Luton Town,3,6,9
11352613,2024-03-30,Aston Villa,Wolverhampton,5,4,9
11352614,2024-03-30,Brentford,Manchester United,14,4,18
11406806,2024-03-30,Napoli,Atalanta,7,5,12
11406814,2024-03-30,Genoa,Frosinone,3,8,11
11406810,2024-03-30,Torino,Monza,7,2,9
11406809,2024-03-30,Lazio,Juventus,7,2,9
11406804,2024-03-30,Fiorentina,Milan,7,5,12
11368703,2024-03-30,Cádiz,Granada,5,2,7
11368691,2024-03-30,Getafe,Sevilla,6,3,9
11368706,2024-03-30,Almería,Osasuna,6,1,7
11368697,2024-03-30,Valencia,Mallorca,3,3,6
11368704,2024-03-30,Barcelona,Las Palmas,6,1,7
11396243,2024-03-30,Bayer 04 Leverkusen,TSG Hoffenheim,9,2,11
11396241,2024-03-30,Borussia M'gladbach,SC Freiburg,14,1,15
11396242,2024-03-30,Eintracht Frankfurt,1. FC Union Berlin,6,2,8
11396244,2024-03-30,RB Leipzig,1. FSV Mainz 05,12,2,14
11396240,2024-03-30,SV Werder Bremen,VfL Wolfsburg,3,6,9
11396245,2024-03-30,FC Bayern München,Borussia Dortmund,7,4,11
11391315,2024-03-30,Lille,RC Lens,5,5,10
11391322,2024-03-30,Metz,AS Monaco,5,5,10
11391316,2024-03-30,Olympique Lyonnais,Stade de Reims,7,8,15
11391317,2024-03-30,Lorient,Stade Brestois,6,4,10
11406806,2024-03-29,Napoli,Atalanta,7,5,12
11368703,2024-03-29,Cádiz,Granada,5,2,7
11391315,2024-03-29,Lille,RC Lens,5,5,10
11352609,2024-03-18,West Ham United,Aston Villa,7,10,17
11406818,2024-03-18,Juventus,Genoa,12,2,14
11406822,2024-03-18,Hellas Verona,Milan,3,5,8
11406824,2024-03-18,Roma,Sassuolo,4,7,11
11406815,2024-03-18,Inter,Napoli,5,7,12
11368713,2024-03-18,Sevilla,Celta Vigo,3,8,11
11368705,2024-03-18,Las Palmas,Almería,11,3,14
11368708,2024-03-18,Villarreal,Valencia,5,2,7
11368700,2024-03-18,Rayo Vallecano,Real Betis,4,8,12
11368701,2024-03-18,Atlético Madrid,Barcelona,7,3,10
11396252,2024-03-18,SC Freiburg,Bayer 04 Leverkusen,2,8,10
11396256,2024-03-18,Borussia Dortmund,Eintracht Frankfurt,8,3,11
11391324,2024-03-18,Stade Brestois,Lille,3,3,6
11391339,2024-03-18,AS Monaco,Lorient,10,8,18
11391341,2024-03-18,Clermont Foot,Le Havre,3,5,8
11391349,2024-03-18,Stade de Reims,Metz,7,7,14
11391334,2024-03-18,Stade Rennais,Olympique de Marseille,4,5,9
11391325,2024-03-18,Montpellier,Paris Saint-Germain,7,4,11
11352599,2024-03-17,Burnley,Brentford,5,4,9
11352606,2024-03-17,Luton Town,Nottingham Forest,6,7,13
11352604,2024-03-17,Fulham,Tottenham Hotspur,4,5,9
11352609,2024-03-17,West Ham United,Aston Villa,7,10,17
11406819,2024-03-17,Monza,Cagliari,3,7,10
11406800,2024-03-17,Udinese,Torino,3,4,7
11406825,2024-03-17,Salernitana,Lecce,7,1,8
11406823,2024-03-17,Frosinone,Lazio,9,4,13
11406818,2024-03-17,Juventus,Genoa,12,2,14
11406822,2024-03-17,Hellas Verona,Milan,3,5,8
11406824,2024-03-17,Roma,Sassuolo,4,7,11
11406815,2024-03-17,Inter,Napoli,5,7,12
11368698,2024-03-17,Mallorca,Granada,10,2,12
11368711,2024-03-17,Osasuna,Real Madrid,5,7,12
11368699,2024-03-17,Getafe,Girona FC,2,5,7
11368712,2024-03-17,Athletic Club,Deportivo Alavés,5,4,9
11368713,2024-03-17,Sevilla,Celta Vigo,3,8,11
11368705,2024-03-17,Las Palmas,Almería,11,3,14
11368708,2024-03-17,Villarreal,Valencia,5,2,7
11368700,2024-03-17,Rayo Vallecano,Real Betis,4,8,12
11368701,2024-03-17,Atlético Madrid,Barcelona,7,3,10
11396247,2024-03-17,1. FC Heidenheim,Borussia M'gladbach,10,4,14
11396253,2024-03-17,1. FC Union Berlin,SV Werder Bremen,4,3,7
11396250,2024-03-17,1. FSV Mainz 05,VfL Bochum 1848,7,6,13
11396246,2024-03-17,Darmstadt 98,FC Bayern München,2,9,11
11396251,2024-03-17,VfL Wolfsburg,FC Augsburg,8,6,14
11396249,2024-03-17,TSG Hoffenheim,VfB Stuttgart,5,6,11
11396252,2024-03-17,SC Freiburg,Bayer 04 Leverkusen,2,8,10
11396256,2024-03-17,Borussia Dortmund,Eintracht Frankfurt,8,3,11
11391338,2024-03-17,Nantes,RC Strasbourg,4,5,9
11391343,2024-03-17,RC Lens,Nice,11,3,14
11391324,2024-03-17,Stade Brestois,Lille,3,3,6
11391339,2024-03-17,AS Monaco,Lorient,10,8,18
11391341,2024-03-17,Clermont Foot,Le Havre,3,5,8
11391349,2024-03-17,Stade de Reims,Metz,7,7,14
11391334,2024-03-17,Stade Rennais,Olympique de Marseille,4,5,9
11391325,2024-03-17,Montpellier,Paris Saint-Germain,7,4,11
11352599,2024-03-16,Burnley,Brentford,5,4,9
11352606,2024-03-16,Luton Town,Nottingham Forest,6,7,13
11352604,2024-03-16,Fulham,Tottenham Hotspur,4,5,9
11406817,2024-03-16,Empoli,Bologna,7,6,13
11406819,2024-03-16,Monza,Cagliari,3,7,10
11406800,2024-03-16,Udinese,Torino,3,4,7
11406825,2024-03-16,Salernitana,Lecce,7,1,8
11406823,2024-03-16,Frosinone,Lazio,9,4,13
11406818,2024-03-16,Juventus,Genoa,12,2,14
11368710,2024-03-16,Real Sociedad,Cádiz,8,2,10
11368698,2024-03-16,Mallorca,Granada,10,2,12
11368711,2024-03-16,Osasuna,Real Madrid,5,7,12
11368699,2024-03-16,Getafe,Girona FC,2,5,7
11368712,2024-03-16,Athletic Club,Deportivo Alavés,5,4,9
11396248,2024-03-16,1. FC Köln,RB Leipzig,3,6,9
11396247,2024-03-16,1. FC Heidenheim,Borussia M'gladbach,10,4,14
11396253,2024-03-16,1. FC Union Berlin,SV Werder Bremen,4,3,7
11396250,2024-03-16,1. FSV Mainz 05,VfL Bochum 1848,7,6,13
11396246,2024-03-16,Darmstadt 98,FC Bayern München,2,9,11
11396251,2024-03-16,VfL Wolfsburg,FC Augsburg,8,6,14
11396249,2024-03-16,TSG Hoffenheim,VfB Stuttgart,5,6,11
11391335,2024-03-16,Toulouse,Olympique Lyonnais,5,3,8
11391338,2024-03-16,Nantes,RC Strasbourg,4,5,9
11391343,2024-03-16,RC Lens,Nice,11,3,14
11406817,2024-03-15,Empoli,Bologna,7,6,13
11368710,2024-03-15,Real Sociedad,Cádiz,8,2,10
11396248,2024-03-15,1. FC Köln,RB Leipzig,3,6,9
11391335,2024-03-15,Toulouse,Olympique Lyonnais,5,3,8
11977248,2024-03-14,Bournemouth,Luton Town,11,3,14
11977248,2024-03-13,Bournemouth,Luton Town,11,3,14
11352581,2024-03-12,Chelsea,Newcastle United,0,4,4
11406811,2024-03-12,Lazio,Udinese,9,5,14
11368715,2024-03-12,Almería,Sevilla,1,8,9
11352575,2024-03-11,Aston Villa,Tottenham Hotspur,6,4,10
11352579,2024-03-11,Brighton & Hove Albion,Nottingham Forest,6,3,9
11352593,2024-03-11,West Ham United,Burnley,4,3,7
11352588,2024-03-11,Liverpool,Manchester City,7,4,11
11352581,2024-03-11,Chelsea,Newcastle United,0,4,4
11406802,2024-03-11,Lecce,Hellas Verona,11,6,17
11406820,2024-03-11,Milan,Empoli,11,4,15
11406837,2024-03-11,Juventus,Atalanta,4,3,7
11406835,2024-03-11,Fiorentina,Roma,8,2,10
11406811,2024-03-11,Lazio,Udinese,9,5,14
11368720,2024-03-11,Deportivo Alavés,Rayo Vallecano,7,5,12
11368718,2024-03-11,Las Palmas,Athletic Club,10,3,13
11368722,2024-03-11,Real Madrid,Celta Vigo,12,1,13
11368716,2024-03-11,Real Betis,Villarreal,11,4,15
11368715,2024-03-11,Almería,Sevilla,1,8,9
11396255,2024-03-11,VfL Bochum 1848,SC Freiburg,12,5,17
11396257,2024-03-11,Eintracht Frankfurt,TSG Hoffenheim,5,1,6
11396259,2024-03-11,Bayer 04 Leverkusen,VfL Wolfsburg,9,2,11
11391356,2024-03-11,Paris Saint-Germain,Stade de Reims,7,2,9
11391333,2024-03-11,Le Havre,Toulouse,3,3,6
11391336,2024-03-11,Metz,Clermont Foot,5,7,12
11391354,2024-03-11,RC Strasbourg,AS Monaco,5,8,13
11391329,2024-03-11,Lille,Stade Rennais,6,3,9
11391321,2024-03-11,Olympique de Marseille,Nantes,2,8,10
11352591,2024-03-10,Manchester United,Everton,5,8,13
11352567,2024-03-10,Bournemouth,Sheffield United,10,3,13
11352585,2024-03-10,Crystal Palace,Luton Town,8,6,14
11352595,2024-03-10,Wolverhampton,Fulham,3,4,7
11352572,2024-03-10,Arsenal,Brentford,10,4,14
11352575,2024-03-10,Aston Villa,Tottenham Hotspur,6,4,10
11352579,2024-03-10,Brighton & Hove Albion,Nottingham Forest,6,3,9
11352593,2024-03-10,West Ham United,Burnley,4,3,7
11352588,2024-03-10,Liverpool,Manchester City,7,4,11
11406836,2024-03-10,Cagliari,Salernitana,5,4,9
11406821,2024-03-10,Sassuolo,Frosinone,1,2,3
11406834,2024-03-10,Bologna,Inter,7,2,9
11406838,2024-03-10,Genoa,Monza,10,1,11
11406802,2024-03-10,Lecce,Hellas Verona,11,6,17
11406820,2024-03-10,Milan,Empoli,11,4,15
11406837,2024-03-10,Juventus,Atalanta,4,3,7
11406835,2024-03-10,Fiorentina,Roma,8,2,10
11368723,2024-03-10,Valencia,Getafe,5,5,10
11368721,2024-03-10,Cádiz,Atlético Madrid,3,1,4
11368717,2024-03-10,Granada,Real Sociedad,4,6,10
11368719,2024-03-10,Girona FC,Osasuna,5,7,12
11368720,2024-03-10,Deportivo Alavés,Rayo Vallecano,7,5,12
11368718,2024-03-10,Las Palmas,Athletic Club,10,3,13
11368722,2024-03-10,Real Madrid,Celta Vigo,12,1,13
11368716,2024-03-10,Real Betis,Villarreal,11,4,15
11396258,2024-03-10,Borussia M'gladbach,1. FC Köln,8,3,11
11396264,2024-03-10,FC Augsburg,1. FC Heidenheim,5,2,7
11396262,2024-03-10,FC Bayern München,1. FSV Mainz 05,6,7,13
11396260,2024-03-10,RB Leipzig,Darmstadt 98,8,4,12
11396254,2024-03-10,SV Werder Bremen,Borussia Dortmund,11,4,15
11396255,2024-03-10,VfL Bochum 1848,SC Freiburg,12,5,17
11396257,2024-03-10,Eintracht Frankfurt,TSG Hoffenheim,5,1,6
11396259,2024-03-10,Bayer 04 Leverkusen,VfL Wolfsburg,9,2,11
11391330,2024-03-10,Lorient,Olympique Lyonnais,4,7,11
11391332,2024-03-10,RC Lens,Stade Brestois,2,4,6
11391356,2024-03-10,Paris Saint-Germain,Stade de Reims,7,2,9
11391333,2024-03-10,Le Havre,Toulouse,3,3,6
11391336,2024-03-10,Metz,Clermont Foot,5,7,12
11391354,2024-03-10,RC Strasbourg,AS Monaco,5,8,13
11391329,2024-03-10,Lille,Stade Rennais,6,3,9
11391321,2024-03-10,Olympique de Marseille,Nantes,2,8,10
11352591,2024-03-09,Manchester United,Everton,5,8,13
11352567,2024-03-09,Bournemouth,Sheffield United,10,3,13
11352585,2024-03-09,Crystal Palace,Luton Town,8,6,14
11352595,2024-03-09,Wolverhampton,Fulham,3,4,7
11352572,2024-03-09,Arsenal,Brentford,10,4,14
11406813,2024-03-09,Napoli,Torino,13,7,20
11406836,2024-03-09,Cagliari,Salernitana,5,4,9
11406821,2024-03-09,Sassuolo,Frosinone,1,2,3
11406834,2024-03-09,Bologna,Inter,7,2,9
11406838,2024-03-09,Genoa,Monza,10,1,11
11406802,2024-03-09,Lecce,Hellas Verona,11,6,17
11368714,2024-03-09,Barcelona,Mallorca,4,1,5
11368723,2024-03-09,Valencia,Getafe,5,5,10
11368721,2024-03-09,Cádiz,Atlético Madrid,3,1,4
11368717,2024-03-09,Granada,Real Sociedad,4,6,10
11368719,2024-03-09,Girona FC,Osasuna,5,7,12
11396261,2024-03-09,VfB Stuttgart,1. FC Union Berlin,4,3,7
11396258,2024-03-09,Borussia M'gladbach,1. FC Köln,8,3,11
11396264,2024-03-09,FC Augsburg,1. FC Heidenheim,5,2,7
11396262,2024-03-09,FC Bayern München,1. FSV Mainz 05,6,7,13
11396260,2024-03-09,RB Leipzig,Darmstadt 98,8,4,12
11396254,2024-03-09,SV Werder Bremen,Borussia Dortmund,11,4,15
11391331,2024-03-09,Nice,Montpellier,8,5,13
11391330,2024-03-09,Lorient,Olympique Lyonnais,4,7,11
11391332,2024-03-09,RC Lens,Stade Brestois,2,4,6
11406813,2024-03-08,Napoli,Torino,13,7,20
11368714,2024-03-08,Barcelona,Mallorca,4,1,5
11396261,2024-03-08,VfB Stuttgart,1. FC Union Berlin,4,3,7
11391331,2024-03-08,Nice,Montpellier,8,5,13
11352560,2024-03-05,Sheffield United,Arsenal,0,7,7
11406828,2024-03-05,Inter,Genoa,4,5,9
11368731,2024-03-05,Osasuna,Deportivo Alavés,5,5,10
11352533,2024-03-04,Burnley,Bournemouth,7,2,9
11352548,2024-03-04,Manchester City,Manchester United,15,2,17
11352560,2024-03-04,Sheffield United,Arsenal,0,7,7
11406827,2024-03-04,Hellas Verona,Sassuolo,2,10,12
11406853,2024-03-04,Empoli,Cagliari,9,2,11
11406826,2024-03-04,Frosinone,Lecce,12,8,20
11406852,2024-03-04,Atalanta,Bologna,6,2,8
11406831,2024-03-04,Napoli,Juventus,2,1,3
11406828,2024-03-04,Inter,Genoa,4,5,9
11368729,2024-03-04,Villarreal,Granada,6,4,10
11368733,2024-03-04,Atlético Madrid,Real Betis,4,6,10
11368727,2024-03-04,Mallorca,Girona FC,8,5,13
11368732,2024-03-04,Athletic Club,Barcelona,4,4,8
11368731,2024-03-04,Osasuna,Deportivo Alavés,5,5,10
11396268,2024-03-04,1. FC Köln,Bayer 04 Leverkusen,1,9,10
11396267,2024-03-04,TSG Hoffenheim,SV Werder Bremen,3,3,6
11391342,2024-03-04,Toulouse,Nice,7,6,13
11391348,2024-03-04,Montpellier,RC Strasbourg,8,4,12
11391352,2024-03-04,Nantes,Metz,10,3,13
11391351,2024-03-04,Stade Brestois,Le Havre,0,2,2
11391337,2024-03-04,Stade Rennais,Lorient,6,3,9
11391350,2024-03-04,Olympique Lyonnais,RC Lens,2,4,6
11352530,2024-03-03,Brentford,Chelsea,0,6,6
11352537,2024-03-03,Everton,West Ham United,4,5,9
11352540,2024-03-03,Fulham,Brighton & Hove Albion,2,6,8
11352553,2024-03-03,Newcastle United,Wolverhampton,3,5,8
11352556,2024-03-03,Nottingham Forest,Liverpool,3,12,15
11352564,2024-03-03,Tottenham Hotspur,Crystal Palace,11,1,12
11352545,2024-03-03,Luton Town,Aston Villa,8,6,14
11352533,2024-03-03,Burnley,Bournemouth,7,2,9
11352548,2024-03-03,Manchester City,Manchester United,15,2,17
11406832,2024-03-03,Udinese,Salernitana,5,6,11
11406833,2024-03-03,Monza,Roma,6,3,9
11406830,2024-03-03,Torino,Fiorentina,4,5,9
11406827,2024-03-03,Hellas Verona,Sassuolo,2,10,12
11406853,2024-03-03,Empoli,Cagliari,9,2,11
11406826,2024-03-03,Frosinone,Lecce,12,8,20
11406852,2024-03-03,Atalanta,Bologna,6,2,8
11406831,2024-03-03,Napoli,Juventus,2,1,3
11368726,2024-03-03,Sevilla,Real Sociedad,2,5,7
11368725,2024-03-03,Rayo Vallecano,Cádiz,4,9,13
11368728,2024-03-03,Getafe,Las Palmas,4,4,8
11368730,2024-03-03,Valencia,Real Madrid,2,2,4
11368729,2024-03-03,Villarreal,Granada,6,4,10
11368733,2024-03-03,Atlético Madrid,Real Betis,4,6,10
11368727,2024-03-03,Mallorca,Girona FC,8,5,13
11368732,2024-03-03,Athletic Club,Barcelona,4,4,8
11396263,2024-03-03,1. FC Heidenheim,Eintracht Frankfurt,7,3,10
11396272,2024-03-03,1. FC Union Berlin,Borussia Dortmund,8,7,15
11396269,2024-03-03,1. FSV Mainz 05,Borussia M'gladbach,12,6,18
11396265,2024-03-03,Darmstadt 98,FC Augsburg,3,6,9
11396266,2024-03-03,VfL Bochum 1848,RB Leipzig,2,5,7
11396270,2024-03-03,VfL Wolfsburg,VfB Stuttgart,5,4,9
11396268,2024-03-03,1. FC Köln,Bayer 04 Leverkusen,1,9,10
11396267,2024-03-03,TSG Hoffenheim,SV Werder Bremen,3,3,6
11391346,2024-03-03,Stade de Reims,Lille,4,4,8
11391347,2024-03-03,Clermont Foot,Olympique de Marseille,7,4,11
11391342,2024-03-03,Toulouse,Nice,7,6,13
11391348,2024-03-03,Montpellier,RC Strasbourg,8,4,12
11391352,2024-03-03,Nantes,Metz,10,3,13
11391351,2024-03-03,Stade Brestois,Le Havre,0,2,2
11391337,2024-03-03,Stade Rennais,Lorient,6,3,9
11391350,2024-03-03,Olympique Lyonnais,RC Lens,2,4,6
11352530,2024-03-02,Brentford,Chelsea,0,6,6
11352537,2024-03-02,Everton,West Ham United,4,5,9
11352540,2024-03-02,Fulham,Brighton & Hove Albion,2,6,8
11352553,2024-03-02,Newcastle United,Wolverhampton,3,5,8
11352556,2024-03-02,Nottingham Forest,Liverpool,3,12,15
11352564,2024-03-02,Tottenham Hotspur,Crystal Palace,11,1,12
11352545,2024-03-02,Luton Town,Aston Villa,8,6,14
11406829,2024-03-02,Lazio,Milan,2,5,7
11406832,2024-03-02,Udinese,Salernitana,5,6,11
11406833,2024-03-02,Monza,Roma,6,3,9
11406830,2024-03-02,Torino,Fiorentina,4,5,9
11406827,2024-03-02,Hellas Verona,Sassuolo,2,10,12
11368724,2024-03-02,Celta Vigo,Almería,7,0,7
11368726,2024-03-02,Sevilla,Real Sociedad,2,5,7
11368725,2024-03-02,Rayo Vallecano,Cádiz,4,9,13
11368728,2024-03-02,Getafe,Las Palmas,4,4,8
11368730,2024-03-02,Valencia,Real Madrid,2,2,4
11396271,2024-03-02,SC Freiburg,FC Bayern München,3,6,9
11396263,2024-03-02,1. FC Heidenheim,Eintracht Frankfurt,7,3,10
11396272,2024-03-02,1. FC Union Berlin,Borussia Dortmund,8,7,15
11396269,2024-03-02,1. FSV Mainz 05,Borussia M'gladbach,12,6,18
11396265,2024-03-02,Darmstadt 98,FC Augsburg,3,6,9
11396266,2024-03-02,VfL Bochum 1848,RB Leipzig,2,5,7
11396270,2024-03-02,VfL Wolfsburg,VfB Stuttgart,5,4,9
11391340,2024-03-02,AS Monaco,Paris Saint-Germain,5,6,11
11391346,2024-03-02,Stade de Reims,Lille,4,4,8
11391347,2024-03-02,Clermont Foot,Olympique de Marseille,7,4,11
11406829,2024-03-01,Lazio,Milan,2,5,7
11368724,2024-03-01,Celta Vigo,Almería,7,0,7
11396271,2024-03-01,SC Freiburg,FC Bayern München,3,6,9
11391340,2024-03-01,AS Monaco,Paris Saint-Germain,5,6,11
11406910,2024-02-29,Sassuolo,Napoli,5,10,15
11930405,2024-02-29,Inter,Atalanta,4,1,5
11406910,2024-02-28,Sassuolo,Napoli,5,10,15
11930405,2024-02-28,Inter,Atalanta,4,1,5
11352521,2024-02-27,West Ham United,Brentford,1,7,8
11406848,2024-02-27,Roma,Torino,0,4,4
11406844,2024-02-27,Fiorentina,Lazio,13,2,15
11368740,2024-02-27,Girona FC,Rayo Vallecano,2,2,4
11352525,2024-02-26,Wolverhampton,Sheffield United,5,6,11
11352521,2024-02-26,West Ham United,Brentford,1,7,8
11406846,2024-02-26,Juventus,Frosinone,8,3,11
11406843,2024-02-26,Cagliari,Napoli,4,3,7
11406847,2024-02-26,Lecce,Inter,7,10,17
11406849,2024-02-26,Milan,Atalanta,5,3,8
11406848,2024-02-26,Roma,Torino,0,4,4
11406844,2024-02-26,Fiorentina,Lazio,13,2,15
11368739,2024-02-26,Cádiz,Celta Vigo,9,1,10
11368744,2024-02-26,Real Betis,Athletic Club,5,3,8
11368742,2024-02-26,Las Palmas,Osasuna,6,7,13
11368736,2024-02-26,Real Madrid,Sevilla,7,2,9
11368740,2024-02-26,Girona FC,Rayo Vallecano,2,2,4
11396277,2024-02-26,Eintracht Frankfurt,VfL Wolfsburg,5,3,8
11396280,2024-02-26,Borussia Dortmund,TSG Hoffenheim,10,3,13
11396274,2024-02-26,FC Augsburg,SC Freiburg,10,2,12
11391368,2024-02-26,RC Lens,AS Monaco,9,3,12
11391345,2024-02-26,Le Havre,Stade de Reims,5,5,10
11391367,2024-02-26,Nice,Clermont Foot,8,1,9
11391364,2024-02-26,Toulouse,Lille,6,8,14
11391362,2024-02-26,Paris Saint-Germain,Stade Rennais,4,0,4
11391365,2024-02-26,Olympique de Marseille,Montpellier,7,4,11
